Microsoft Corporation	NasdaqGS:MSFT	Systems Software
Apple Inc.	NasdaqGS:AAPL	Technology Hardware, Storage and Peripherals
Amazon.com, Inc.	NasdaqGS:AMZN	Internet and Direct Marketing Retail
Alphabet Inc.	NasdaqGS:GOOG.L	Interactive Media and Services
Facebook, Inc.	NasdaqGS:FB	Interactive Media and Services
Cisco Systems, Inc.	NasdaqGS:CSCO	Communications Equipment
Intel Corporation	NasdaqGS:INTC	Semiconductors
Comcast Corporation	NasdaqGS:CMCS.A	Cable and Satellite
PepsiCo, Inc.	NasdaqGS:PEP	Soft Drinks
Adobe Inc.	NasdaqGS:ADBE	Application Software
Netflix, Inc.	NasdaqGS:NFLX	Movies and Entertainment
PayPal Holdings, Inc.	NasdaqGS:PYPL	Data Processing and Outsourced Services
Costco Wholesale Corporation	NasdaqGS:COST	Hypermarkets and Super Centers
Amgen Inc.	NasdaqGS:AMGN	Biotechnology
Starbucks Corporation	NasdaqGS:SBUX	Restaurants
Texas Instruments Incorporated	NasdaqGS:TXN	Semiconductors
Broadcom Inc.	NasdaqGS:AVGO	Semiconductors
NVIDIA Corporation	NasdaqGS:NVDA	Semiconductors
QUALCOMM Incorporated	NasdaqGS:QCOM	Semiconductors
Charter Communications, Inc.	NasdaqGS:CHTR	Cable and Satellite
Gilead Sciences, Inc.	NasdaqGS:GILD	Biotechnology
Booking Holdings Inc.	NasdaqGS:BKNG	Internet and Direct Marketing Retail
Mondelez International, Inc.	NasdaqGS:MDLZ	Packaged Foods and Meats
CME Group Inc.	NasdaqGS:CME	Financial Exchanges and Data
Automatic Data Processing, Inc.	NasdaqGS:ADP	Data Processing and Outsourced Services
Intuit Inc.	NasdaqGS:INTU	Application Software
Fiserv, Inc.	NasdaqGS:FISV	Data Processing and Outsourced Services
Celgene Corporation	NasdaqGS:CELG	Biotechnology
T-Mobile US, Inc.	NasdaqGS:TMUS	Wireless Telecommunication Services
Intuitive Surgical, Inc.	NasdaqGS:ISRG	Health Care Equipment
CSX Corporation	NasdaqGS:CSX	Railroads
Walgreens Boots Alliance, Inc.	NasdaqGS:WBA	Drug Retail
Vertex Pharmaceuticals Incorporated	NasdaqGS:VRTX	Biotechnology
Micron Technology, Inc.	NasdaqGS:MU	Semiconductors
Applied Materials, Inc.	NasdaqGS:AMAT	Semiconductor Equipment
Marriott International, Inc.	NasdaqGS:MAR	Hotels, Resorts and Cruise Lines
Biogen Inc.	NasdaqGS:BIIB	Biotechnology
Workday, Inc.	NasdaqGS:WDAY	Application Software
Illumina, Inc.	NasdaqGS:ILMN	Life Sciences Tools and Services
Tesla, Inc.	NasdaqGS:TSLA	Automobile Manufacturers
Analog Devices, Inc.	NasdaqGS:ADI	Semiconductors
JD.com, Inc.	NasdaqGS:JD	Internet and Direct Marketing Retail
Ross Stores, Inc.	NasdaqGS:ROST	Apparel Retail
Advanced Micro Devices, Inc.	NasdaqGS:AMD	Semiconductors
Activision Blizzard, Inc.	NasdaqGS:ATVI	Interactive Home Entertainment
Atlassian Corporation Plc	NasdaqGS:TEAM	Application Software
Cognizant Technology Solutions Corporation	NasdaqGS:CTSH	IT Consulting and Other Services
Baidu, Inc.	NasdaqGS:BIDU	Interactive Media and Services
MercadoLibre, Inc.	NasdaqGS:MELI	Internet and Direct Marketing Retail
eBay Inc.	NasdaqGS:EBAY	Internet and Direct Marketing Retail
Regeneron Pharmaceuticals, Inc.	NasdaqGS:REGN	Biotechnology
Autodesk, Inc.	NasdaqGS:ADSK	Application Software
The Kraft Heinz Company	NasdaqGS:KHC	Packaged Foods and Meats
Monster Beverage Corporation	NasdaqGS:MNST	Soft Drinks
Xcel Energy Inc.	NasdaqGS:XEL	Electric Utilities
NetEase, Inc.	NasdaqGS:NTES	Interactive Home Entertainment
Paychex, Inc.	NasdaqGS:PAYX	Data Processing and Outsourced Services
O'Reilly Automotive, Inc.	NasdaqGS:ORLY	Automotive Retail
SBA Communications Corporation	NasdaqGS:SBAC	Specialized REITs
Lam Research Corporation	NasdaqGS:LRCX	Semiconductor Equipment
NXP Semiconductors N.V.	NasdaqGS:NXPI	Semiconductors
Sirius XM Holdings Inc.	NasdaqGS:SIRI	Cable and Satellite
Electronic Arts Inc.	NasdaqGS:EA	Interactive Home Entertainment
Cintas Corporation	NasdaqGS:CTAS	Diversified Support Services
Xilinx, Inc.	NasdaqGS:XLNX	Semiconductors
Pinduoduo Inc.	NasdaqGS:PDD	Internet and Direct Marketing Retail
Zoom Video Communications, Inc.	NasdaqGS:ZM	Application Software
T. Rowe Price Group, Inc.	NasdaqGS:TROW	Asset Management and Custody Banks
Verisk Analytics, Inc.	NasdaqGS:VRSK	Research and Consulting Services
Willis Towers Watson Public Limited Company	NasdaqGS:WLTW	Insurance Brokers
Alexion Pharmaceuticals, Inc.	NasdaqGS:ALXN	Biotechnology
VeriSign, Inc.	NasdaqGS:VRSN	Internet Services and Infrastructure
TD Ameritrade Holding Corporation	NasdaqGS:AMTD	Investment Banking and Brokerage
Match Group, Inc.	NasdaqGS:MTCH	Interactive Media and Services
IDEXX Laboratories, Inc.	NasdaqGS:IDXX	Health Care Equipment
Lululemon Athletica Inc.	NasdaqGS:LULU	Apparel, Accessories and Luxury Goods
CoStar Group, Inc.	NasdaqGS:CSGP	Research and Consulting Services
Cerner Corporation	NasdaqGS:CERN	Health Care Technology
PACCAR Inc	NasdaqGS:PCAR	Construction Machinery and Heavy Trucks
United Airlines Holdings, Inc.	NasdaqGS:UAL	Airlines
KLA Corporation	NasdaqGS:KLAC	Semiconductor Equipment
Fox Corporation	NasdaqGS:FOXA	Broadcasting
Expedia Group, Inc.	NasdaqGS:EXPE	Internet and Direct Marketing Retail
IAC/InterActiveCorp	NasdaqGS:IAC	Interactive Media and Services
Dollar Tree, Inc.	NasdaqGS:DLTR	General Merchandise Stores
Microchip Technology Incorporated	NasdaqGS:MCHP	Semiconductors
Ulta Beauty, Inc.	NasdaqGS:ULTA	Specialty Stores
Discovery, Inc.	NasdaqGS:DISC.A	Broadcasting
Cadence Design Systems, Inc.	NasdaqGS:CDNS	Application Software
Synopsys, Inc.	NasdaqGS:SNPS	Application Software
Splunk Inc.	NasdaqGS:SPLK	Application Software
Fifth Third Bancorp	NasdaqGS:FITB	Regional Banks
CrowdStrike Holdings, Inc.	NasdaqGS:CRWD	Systems Software
Northern Trust Corporation	NasdaqGS:NTRS	Asset Management and Custody Banks
Ctrip.com International, Ltd.	NasdaqGS:CTRP	Internet and Direct Marketing Retail
Liberty Global Plc	NasdaqGS:LBTY.A	Cable and Satellite
Liberty Broadband Corporation	NasdaqGS:LBRD.K	Cable and Satellite
Cincinnati Financial Corporation	NasdaqGS:CINF	Property and Casualty Insurance
Incyte Corporation	NasdaqGS:INCY	Biotechnology
ANSYS, Inc.	NasdaqGS:ANSS	Application Software
Copart, Inc.	NasdaqGS:CPRT	Diversified Support Services
Lyft, Inc.	NasdaqGS:LYFT	Trucking
Fastenal Company	NasdaqGS:FAST	Trading Companies and Distributors
Check Point Software Technologies Ltd.	NasdaqGS:CHKP	Systems Software
CDW Corporation	NasdaqGS:CDW	Technology Distributors
Marvell Technology Group Ltd.	NasdaqGS:MRVL	Semiconductors
Nasdaq, Inc.	NasdaqGS:NDAQ	Financial Exchanges and Data
Western Digital Corporation	NasdaqGS:WDC	Technology Hardware, Storage and Peripherals
Arch Capital Group Ltd.	NasdaqGS:ACGL	Property and Casualty Insurance
Diamondback Energy, Inc.	NasdaqGS:FANG	Oil and Gas Exploration and Production
Principal Financial Group, Inc.	NasdaqGS:PFG	Life and Health Insurance
Okta, Inc.	NasdaqGS:OKTA	Internet Services and Infrastructure
Exact Sciences Corporation	NasdaqCM:EXAS	Biotechnology
DISH Network Corporation	NasdaqGS:DISH	Cable and Satellite
Icahn Enterprises L.P.	NasdaqGS:IEP	Industrial Conglomerates
Garmin Ltd.	NasdaqGS:GRMN	Consumer Electronics
Akamai Technologies, Inc.	NasdaqGS:AKAM	Internet Services and Infrastructure
Maxim Integrated Products, Inc.	NasdaqGS:MXIM	Semiconductors
Align Technology, Inc.	NasdaqGS:ALGN	Health Care Supplies
Roku, Inc.	NasdaqGS:ROKU	Consumer Electronics
Hasbro, Inc.	NasdaqGS:HAS	Leisure Products
Fortinet, Inc.	NasdaqGS:FTNT	Systems Software
Symantec Corporation	NasdaqGS:SYMC	Systems Software
DexCom, Inc.	NasdaqGS:DXCM	Health Care Equipment
BioMarin Pharmaceutical Inc.	NasdaqGS:BMRN	Biotechnology
Take-Two Interactive Software, Inc.	NasdaqGS:TTWO	Interactive Home Entertainment
MarketAxess Holdings Inc.	NasdaqGS:MKTX	Financial Exchanges and Data
Huntington Bancshares Incorporated	NasdaqGS:HBAN	Regional Banks
Hologic, Inc.	NasdaqGS:HOLX	Health Care Equipment
Skyworks Solutions, Inc.	NasdaqGS:SWKS	Semiconductors
Old Dominion Freight Line, Inc.	NasdaqGS:ODFL	Trucking
The Liberty SiriusXM Group	NasdaqGS:LSXM.K	Cable and Satellite
Seattle Genetics, Inc.	NasdaqGS:SGEN	Biotechnology
Tractor Supply Company	NasdaqGS:TSCO	Specialty Stores
American Airlines Group Inc.	NasdaqGS:AAL	Airlines
iQIYI, Inc.	NasdaqGS:IQ	Movies and Entertainment
Expeditors International of Washington, Inc.	NasdaqGS:EXPD	Air Freight and Logistics
Viacom Inc.	NasdaqGS:VIAB	Movies and Entertainment
Alliant Energy Corporation	NasdaqGS:LNT	Electric Utilities
Yandex N.V.	NasdaqGS:YNDX	Interactive Media and Services
Seagate Technology plc	NasdaqGS:STX	Technology Hardware, Storage and Peripherals
The Trade Desk, Inc.	NasdaqGM:TTD	Application Software
Citrix Systems, Inc.	NasdaqGS:CTXS	Application Software
DENTSPLY SIRONA Inc.	NasdaqGS:XRAY	Health Care Supplies
Wynn Resorts, Limited	NasdaqGS:WYNN	Casinos and Gaming
SS&C Technologies Holdings, Inc.	NasdaqGS:SSNC	Application Software
C.H. Robinson Worldwide, Inc.	NasdaqGS:CHRW	Air Freight and Logistics
NetApp, Inc.	NasdaqGS:NTAP	Technology Hardware, Storage and Peripherals
Zebra Technologies Corporation	NasdaqGS:ZBRA	Electronic Equipment and Instruments
Regency Centers Corporation	NasdaqGS:REG	Retail REITs
Jack Henry & Associates, Inc.	NasdaqGS:JKHY	Data Processing and Outsourced Services
Zscaler, Inc.	NasdaqGS:ZS	Systems Software
J.B. Hunt Transport Services, Inc.	NasdaqGS:JBHT	Trucking
Open Text Corporation	NasdaqGS:OTEX	Application Software
Erie Indemnity Company	NasdaqGS:ERIE	Property and Casualty Insurance
SVB Financial Group	NasdaqGS:SIVB	Regional Banks
E*TRADE Financial Corporation	NasdaqGS:ETFC	Investment Banking and Brokerage
Mylan N.V.	NasdaqGS:MYL	Pharmaceuticals
Universal Display Corporation	NasdaqGS:OLED	Semiconductors
StoneCo Ltd.	NasdaqGS:STNE	Data Processing and Outsourced Services
Beyond Meat, Inc.	NasdaqGS:BYND	Packaged Foods and Meats
Trimble Inc.	NasdaqGS:TRMB	Electronic Equipment and Instruments
Ionis Pharmaceuticals, Inc.	NasdaqGS:IONS	Biotechnology
Guardant Health, Inc.	NasdaqGS:GH	Health Care Services
Aspen Technology, Inc.	NasdaqGS:AZPN	Application Software
Formula One Group	NasdaqGS:FWON.K	Movies and Entertainment
Sarepta Therapeutics, Inc.	NasdaqGS:SRPT	Biotechnology
AGNC Investment Corp.	NasdaqGS:AGNC	Mortgage REITs
Henry Schein, Inc.	NasdaqGS:HSIC	Health Care Distributors
Melco Resorts & Entertainment Limited	NasdaqGS:MLCO	Casinos and Gaming
Insulet Corporation	NasdaqGS:PODD	Health Care Equipment
Alnylam Pharmaceuticals, Inc.	NasdaqGS:ALNY	Biotechnology
Credit Acceptance Corporation	NasdaqGS:CACC	Consumer Finance
Huazhu Group Limited	NasdaqGS:HTHT	Hotels, Resorts and Cruise Lines
Teradyne, Inc.	NasdaqGS:TER	Semiconductor Equipment
Amdocs Limited	NasdaqGS:DOX	IT Consulting and Other Services
Neurocrine Biosciences, Inc.	NasdaqGS:NBIX	Biotechnology
Sage Therapeutics, Inc.	NasdaqGM:SAGE	Biotechnology
SEI Investments Company	NasdaqGS:SEIC	Asset Management and Custody Banks
Abiomed, Inc.	NasdaqGS:ABMD	Health Care Equipment
Coupa Software Incorporated	NasdaqGS:COUP	Application Software
NovoCure Limited	NasdaqGS:NVCR	Health Care Equipment
Royal Gold, Inc.	NasdaqGS:RGLD	Gold
Cypress Semiconductor Corporation	NasdaqGS:CY	Semiconductors
Euronet Worldwide, Inc.	NasdaqGS:EEFT	Data Processing and Outsourced Services
Masimo Corporation	NasdaqGS:MASI	Health Care Equipment
MongoDB, Inc.	NasdaqGM:MDB	Internet Services and Infrastructure
Qorvo, Inc.	NasdaqGS:QRVO	Semiconductors
Zillow Group, Inc.	NasdaqGS:ZG	Interactive Media and Services
Gaming and Leisure Properties, Inc.	NasdaqGS:GLPI	Specialized REITs
News Corporation	NasdaqGS:NWSA	Publishing
Ubiquiti Networks, Inc.	NasdaqGS:UBNT	Communications Equipment
BeiGene, Ltd.	NasdaqGS:BGNE	Biotechnology
F5 Networks, Inc.	NasdaqGS:FFIV	Communications Equipment
Weibo Corporation	NasdaqGS:WB	Interactive Media and Services
Brookfield Property Partners L.P.	NasdaqGS:BPY	Real Estate Operating Companies
Pool Corporation	NasdaqGS:POOL	Distributors
Lamar Advertising Company (REIT)	NasdaqGS:LAMR	Specialized REITs
Nordson Corporation	NasdaqGS:NDSN	Industrial Machinery
DocuSign, Inc.	NasdaqGS:DOCU	Application Software
LKQ Corporation	NasdaqGS:LKQ	Distributors
Jazz Pharmaceuticals plc	NasdaqGS:JAZZ	Pharmaceuticals
Caesars Entertainment Corporation	NasdaqGS:CZR	Casinos and Gaming
Dropbox, Inc.	NasdaqGS:DBX	Application Software
PTC Inc.	NasdaqGS:PTC	Application Software
Cognex Corporation	NasdaqGS:CGNX	Electronic Equipment and Instruments
Zions Bancorporation, National Association	NasdaqGS:ZION	Regional Banks
CyrusOne Inc.	NasdaqGS:CONE	Specialized REITs
Wix.com Ltd.	NasdaqGS:WIX	Internet Services and Infrastructure
Bio-Techne Corporation	NasdaqGS:TECH	Life Sciences Tools and Services
Pilgrim's Pride Corporation	NasdaqGS:PPC	Packaged Foods and Meats
AMERCO	NasdaqGS:UHAL	Trucking
ON Semiconductor Corporation	NasdaqGS:ON	Semiconductors
Gentex Corporation	NasdaqGS:GNTX	Auto Parts and Equipment
bluebird bio, Inc.	NasdaqGS:BLUE	Biotechnology
Sabre Corporation	NasdaqGS:SABR	Data Processing and Outsourced Services
Etsy, Inc.	NasdaqGS:ETSY	Internet and Direct Marketing Retail
Dunkin' Brands Group, Inc.	NasdaqGS:DNKN	Restaurants
Columbia Sportswear Company	NasdaqGS:COLM	Apparel, Accessories and Luxury Goods
Woodward, Inc.	NasdaqGS:WWD	Industrial Machinery
Newell Brands Inc.	NasdaqGS:NWL	Housewares and Specialties
First Solar, Inc.	NasdaqGS:FSLR	Semiconductors
Morningstar, Inc.	NasdaqGS:MORN	Financial Exchanges and Data
Proofpoint, Inc.	NasdaqGM:PFPT	Systems Software
FLIR Systems, Inc.	NasdaqGS:FLIR	Electronic Equipment and Instruments
Momo Inc.	NasdaqGS:MOMO	Interactive Media and Services
HD Supply Holdings, Inc.	NasdaqGS:HDS	Trading Companies and Distributors
Signature Bank	NasdaqGS:SBNY	Regional Banks
IPG Photonics Corporation	NasdaqGS:IPGP	Electronic Manufacturing Services
Tradeweb Markets Inc.	NasdaqGS:TW	Financial Exchanges and Data
Monolithic Power Systems, Inc.	NasdaqGS:MPWR	Semiconductors
PRA Health Sciences, Inc.	NasdaqGS:PRAH	Life Sciences Tools and Services
Commerce Bancshares, Inc.	NasdaqGS:CBSH	Regional Banks
Bruker Corporation	NasdaqGS:BRKR	Life Sciences Tools and Services
GCI Liberty, Inc.	NasdaqGS:GLIB.A	Alternative Carriers
Steel Dynamics, Inc.	NasdaqGS:STLD	Steel
The Middleby Corporation	NasdaqGS:MIDD	Industrial Machinery
Exelixis, Inc.	NasdaqGS:EXEL	Biotechnology
LPL Financial Holdings Inc.	NasdaqGS:LPLA	Investment Banking and Brokerage
East West Bancorp, Inc.	NasdaqGS:EWBC	Regional Banks
Casey's General Stores, Inc.	NasdaqGS:CASY	Food Retail
Five Below, Inc.	NasdaqGS:FIVE	Specialty Stores
Luckin Coffee Inc.	NasdaqGS:LK	Restaurants
Cree, Inc.	NasdaqGS:CREE	Semiconductors
Grand Canyon Education, Inc.	NasdaqGS:LOPE	Education Services
People's United Financial, Inc.	NasdaqGS:PBCT	Regional Banks
TCF Financial Corporation	NasdaqGS:TCF	Regional Banks
TripAdvisor, Inc.	NasdaqGS:TRIP	Interactive Media and Services
CDK Global, Inc.	NasdaqGS:CDK	Application Software
Mellanox Technologies, Ltd.	NasdaqGS:MLNX	Semiconductors
Paylocity Holding Corporation	NasdaqGS:PCTY	Application Software
National Instruments Corporation	NasdaqGS:NATI	Electronic Equipment and Instruments
JetBlue Airways Corporation	NasdaqGS:JBLU	Airlines
Zynga Inc.	NasdaqGS:ZNGA	Interactive Home Entertainment
RealPage, Inc.	NasdaqGS:RP	Application Software
BOK Financial Corporation	NasdaqGS:BOKF	Regional Banks
Pegasystems Inc.	NasdaqGS:PEGA	Application Software
Qurate Retail, Inc.	NasdaqGS:QRTE.A	Internet and Direct Marketing Retail
Entegris, Inc.	NasdaqGS:ENTG	Semiconductor Equipment
GDS Holdings Limited	NasdaqGM:GDS	Data Processing and Outsourced Services
Medidata Solutions, Inc.	NasdaqGS:MDSO	Health Care Technology
Manhattan Associates, Inc.	NasdaqGS:MANH	Application Software
Ascendis Pharma A/S	NasdaqGS:ASND	Biotechnology
Integra LifeSciences Holdings Corporation	NasdaqGS:IART	Health Care Equipment
Flex Ltd.	NasdaqGS:FLEX	Electronic Manufacturing Services
Syneos Health, Inc.	NasdaqGS:SYNH	Life Sciences Tools and Services
Amarin Corporation plc	NasdaqGM:AMRN	Biotechnology
Popular, Inc.	NasdaqGS:BPOP	Regional Banks
Millicom International Cellular S.A.	NasdaqGS:TIGO	Wireless Telecommunication Services
GW Pharmaceuticals plc	NasdaqGM:GWPH	Pharmaceuticals
HealthEquity, Inc.	NasdaqGS:HQY	Managed Health Care
Lincoln Electric Holdings, Inc.	NasdaqGS:LECO	Industrial Machinery
Ollie's Bargain Outlet Holdings, Inc.	NasdaqGM:OLLI	General Merchandise Stores
Adaptive Biotechnologies Corporation	NasdaqGS:ADPT	Life Sciences Tools and Services
VEON Ltd.	NasdaqGS:VEON	Wireless Telecommunication Services
TFS Financial Corporation	NasdaqGS:TFSL	Thrifts and Mortgage Finance
First Citizens BancShares, Inc.	NasdaqGS:FCNC.A	Regional Banks
Viasat, Inc.	NasdaqGS:VSAT	Communications Equipment
Churchill Downs Incorporated	NasdaqGS:CHDN	Casinos and Gaming
Selective Insurance Group, Inc.	NasdaqGS:SIGI	Property and Casualty Insurance
Nuance Communications, Inc.	NasdaqGS:NUAN	Application Software
Repligen Corporation	NasdaqGS:RGEN	Biotechnology
Lumentum Holdings Inc.	NasdaqGS:LITE	Communications Equipment
The Wendy's Company	NasdaqGS:WEN	Restaurants
Silicon Laboratories Inc.	NasdaqGS:SLAB	Semiconductors
Mercury Systems, Inc.	NasdaqGS:MRCY	Aerospace and Defense
Bilibili Inc.	NasdaqGS:BILI	Interactive Home Entertainment
Blueprint Medicines Corporation	NasdaqGS:BPMC	Biotechnology
ANGI Homeservices Inc.	NasdaqGS:ANGI	Interactive Media and Services
Nexstar Media Group, Inc.	NasdaqGS:NXST	Broadcasting
CyberArk Software Ltd.	NasdaqGS:CYBR	Systems Software
Blackbaud, Inc.	NasdaqGS:BLKB	Application Software
Moderna, Inc.	NasdaqGS:MRNA	Biotechnology
Avnet, Inc.	NasdaqGS:AVT	Technology Distributors
Amedisys, Inc.	NasdaqGS:AMED	Health Care Services
Landstar System, Inc.	NasdaqGS:LSTR	Trucking
ACADIA Pharmaceuticals Inc.	NasdaqGS:ACAD	Biotechnology
Tetra Tech, Inc.	NasdaqGS:TTEK	Environmental and Facilities Services
Pinnacle Financial Partners, Inc.	NasdaqGS:PNFP	Regional Banks
FirstCash, Inc.	NasdaqGS:FCFS	Consumer Finance
First Financial Bankshares, Inc.	NasdaqGS:FFIN	Regional Banks
Lancaster Colony Corporation	NasdaqGS:LANC	Packaged Foods and Meats
CarGurus, Inc.	NasdaqGS:CARG	Interactive Media and Services
frontdoor, inc.	NasdaqGS:FTDR	Specialized Consumer Services
Sinclair Broadcast Group, Inc.	NasdaqGS:SBGI	Broadcasting
51job, Inc.	NasdaqGS:JOBS	Human Resource and Employment Services
Tilray, Inc.	NasdaqGS:TLRY	Pharmaceuticals
Cracker Barrel Old Country Store, Inc.	NasdaqGS:CBRL	Restaurants
YY Inc.	NasdaqGS:YY	Interactive Media and Services
MKS Instruments, Inc.	NasdaqGS:MKSI	Semiconductor Equipment
Stericycle, Inc.	NasdaqGS:SRCL	Environmental and Facilities Services
Sabra Health Care REIT, Inc.	NasdaqGS:SBRA	Health Care REITs
PacWest Bancorp	NasdaqGS:PACW	Regional Banks
Allakos Inc.	NasdaqGS:ALLK	Biotechnology
LendingTree, Inc.	NasdaqGS:TREE	Thrifts and Mortgage Finance
Laureate Education, Inc.	NasdaqGS:LAUR	Education Services
Hospitality Properties Trust	NasdaqGS:HPT	Hotel and Resort REITs
FibroGen, Inc.	NasdaqGS:FGEN	Biotechnology
LivaNova PLC	NasdaqGS:LIVN	Health Care Equipment
j2 Global, Inc.	NasdaqGS:JCOM	Application Software
SolarEdge Technologies, Inc.	NasdaqGS:SEDG	Semiconductor Equipment
RBC Bearings Incorporated	NasdaqGS:ROLL	Industrial Machinery
Spark Therapeutics, Inc.	NasdaqGS:ONCE	Biotechnology
Mattel, Inc.	NasdaqGS:MAT	Leisure Products
Enphase Energy, Inc.	NasdaqGM:ENPH	Semiconductor Equipment
Brighthouse Financial, Inc.	NasdaqGS:BHF	Life and Health Insurance
EchoStar Corporation	NasdaqGS:SATS	Communications Equipment
Enstar Group Limited	NasdaqGS:ESGR	Reinsurance
Littelfuse, Inc.	NasdaqGS:LFUS	Electronic Components
Allogene Therapeutics, Inc.	NasdaqGS:ALLO	Biotechnology
IBERIABANK Corporation	NasdaqGS:IBKC	Regional Banks
Texas Roadhouse, Inc.	NasdaqGS:TXRH	Restaurants
LHC Group, Inc.	NasdaqGS:LHCG	Health Care Services
Wintrust Financial Corporation	NasdaqGS:WTFC	Regional Banks
Five9, Inc.	NasdaqGM:FIVN	Application Software
Tandem Diabetes Care, Inc.	NasdaqGM:TNDM	Health Care Equipment
Strategic Education, Inc.	NasdaqGS:STRA	Education Services
Mirati Therapeutics, Inc.	NasdaqGS:MRTX	Biotechnology
United Bankshares, Inc.	NasdaqGS:UBSI	Regional Banks
Helen of Troy Limited	NasdaqGS:HELE	Household Appliances
Neogen Corporation	NasdaqGS:NEOG	Health Care Supplies
Nektar Therapeutics	NasdaqGS:NKTR	Pharmaceuticals
Verint Systems Inc.	NasdaqGS:VRNT	Application Software
Exponent, Inc.	NasdaqGS:EXPO	Research and Consulting Services
Umpqua Holdings Corporation	NasdaqGS:UMPQ	Regional Banks
United Therapeutics Corporation	NasdaqGS:UTHR	Biotechnology
Nutanix, Inc.	NasdaqGS:NTNX	Application Software
Cimpress N.V.	NasdaqGS:CMPR	Commercial Printing
LogMeIn, Inc.	NasdaqGS:LOGM	Application Software
Valley National Bancorp	NasdaqGS:VLY	Regional Banks
Ultragenyx Pharmaceutical Inc.	NasdaqGS:RARE	Biotechnology
Bank OZK	NasdaqGS:OZK	Regional Banks
J & J Snack Foods Corp.	NasdaqGS:JJSF	Packaged Foods and Meats
MorphoSys AG	XTRA:MOR	Biotechnology
Livongo Health, Inc.	NasdaqGS:LVGO	Health Care Technology
ICU Medical, Inc.	NasdaqGS:ICUI	Health Care Supplies
Axon Enterprise, Inc.	NasdaqGS:AAXN	Aerospace and Defense
NuVasive, Inc.	NasdaqGS:NUVA	Health Care Equipment
Glacier Bancorp, Inc.	NasdaqGS:GBCI	Regional Banks
Silgan Holdings Inc.	NasdaqGS:SLGN	Metal and Glass Containers
TerraForm Power, Inc.	NasdaqGS:TERP	Renewable Electricity
First Hawaiian, Inc.	NasdaqGS:FHB	Regional Banks
Cabot Microelectronics Corporation	NasdaqGS:CCMP	Semiconductor Equipment
Grocery Outlet Holding Corp.	NasdaqGS:GO	Food Retail
Appian Corporation	NasdaqGM:APPN	Systems Software
Myriad Genetics, Inc.	NasdaqGS:MYGN	Biotechnology
Cornerstone OnDemand, Inc.	NasdaqGS:CSOD	Application Software
BridgeBio Pharma, Inc.	NasdaqGS:BBIO	Biotechnology
HMS Holdings Corp.	NasdaqGS:HMSY	Health Care Technology
Coherent, Inc.	NasdaqGS:COHR	Electronic Equipment and Instruments
Qualys, Inc.	NasdaqGS:QLYS	Systems Software
Viavi Solutions Inc.	NasdaqGS:VIAV	Communications Equipment
Tech Data Corporation	NasdaqGS:TECD	Technology Distributors
AppFolio, Inc.	NasdaqGM:APPF	Application Software
Hancock Whitney Corporation	NasdaqGS:HWC	Regional Banks
UMB Financial Corporation	NasdaqGS:UMBF	Regional Banks
ACI Worldwide, Inc.	NasdaqGS:ACIW	Application Software
Eldorado Resorts, Inc.	NasdaqGS:ERI	Casinos and Gaming
Navient Corporation	NasdaqGS:NAVI	Consumer Finance
American National Insurance Company	NasdaqGS:ANAT	Multi-line Insurance
DouYu International Holdings Limited	NasdaqGS:DOYU	Interactive Home Entertainment
Home Bancshares, Inc. (Conway, AR)	NasdaqGS:HOMB	Regional Banks
Cirrus Logic, Inc.	NasdaqGS:CRUS	Semiconductors
Semtech Corporation	NasdaqGS:SMTC	Semiconductors
Sanderson Farms, Inc.	NasdaqGS:SAFM	Packaged Foods and Meats
Iridium Communications Inc.	NasdaqGS:IRDM	Alternative Carriers
Atlantic Union Bankshares Corporation	NasdaqGS:AUB	Regional Banks
CenterState Bank Corporation	NasdaqGS:CSFL	Regional Banks
Wingstop Inc.	NasdaqGS:WING	Restaurants
Omnicell, Inc.	NasdaqGS:OMCL	Health Care Technology
Global Blood Therapeutics, Inc.	NasdaqGS:GBT	Biotechnology
Investors Bancorp, Inc.	NasdaqGS:ISBC	Regional Banks
CVB Financial Corp.	NasdaqGS:CVBF	Regional Banks
AMC Networks Inc.	NasdaqGS:AMCX	Broadcasting
Old National Bancorp	NasdaqGS:ONB	Regional Banks
SkyWest, Inc.	NasdaqGS:SKYW	Airlines
Immunomedics, Inc.	NasdaqGM:IMMU	Biotechnology
BlackLine, Inc.	NasdaqGS:BL	Application Software
Balchem Corporation	NasdaqGS:BCPC	Specialty Chemicals
Fox Factory Holding Corp.	NasdaqGS:FOXF	Auto Parts and Equipment
The Goodyear Tire & Rubber Company	NasdaqGS:GT	Tires and Rubber
Texas Capital Bancshares, Inc.	NasdaqGS:TCBI	Regional Banks
ManTech International Corporation	NasdaqGS:MANT	IT Consulting and Other Services
Medpace Holdings, Inc.	NasdaqGS:MEDP	Life Sciences Tools and Services
Washington Federal, Inc.	NasdaqGS:WAFD	Thrifts and Mortgage Finance
FireEye, Inc.	NasdaqGS:FEYE	Systems Software
Everbridge, Inc.	NasdaqGM:EVBG	Application Software
Rapid7, Inc.	NasdaqGM:RPD	Systems Software
Cathay General Bancorp	NasdaqGS:CATY	Regional Banks
PTC Therapeutics, Inc.	NasdaqGS:PTCT	Biotechnology
Arrowhead Pharmaceuticals, Inc.	NasdaqGS:ARWR	Biotechnology
National General Holdings Corp.	NasdaqGM:NGHC	Multi-line Insurance
Extended Stay America, Inc.	NasdaqGS:STAY	Hotels, Resorts and Cruise Lines
Iovance Biotherapeutics, Inc.	NasdaqGM:IOVA	Biotechnology
Amicus Therapeutics, Inc.	NasdaqGM:FOLD	Biotechnology
Genomic Health, Inc.	NasdaqGS:GHDX	Biotechnology
Wright Medical Group N.V.	NasdaqGS:WMGI	Health Care Equipment
CRISPR Therapeutics AG	NasdaqGM:CRSP	Biotechnology
The Ensign Group, Inc.	NasdaqGS:ENSG	Health Care Facilities
Finisar Corporation	NasdaqGS:FNSR	Communications Equipment
Monro, Inc.	NasdaqGS:MNRO	Automotive Retail
Mimecast Limited	NasdaqGS:MIME	Application Software
Arena Pharmaceuticals, Inc.	NasdaqGS:ARNA	Biotechnology
Fulton Financial Corporation	NasdaqGS:FULT	Regional Banks
Itron, Inc.	NasdaqGS:ITRI	Electronic Equipment and Instruments
CONMED Corporation	NasdaqGS:CNMD	Health Care Equipment
NeoGenomics, Inc.	NasdaqCM:NEO	Life Sciences Tools and Services
Covetrus, Inc.	NasdaqGS:CVET	Health Care Distributors
Acacia Communications, Inc.	NasdaqGS:ACIA	Communications Equipment
Ameris Bancorp	NasdaqGS:ABCB	Regional Banks
MyoKardia, Inc.	NasdaqGS:MYOK	Pharmaceuticals
The Medicines Company	NasdaqGS:MDCO	Biotechnology
South State Corporation	NasdaqGS:SSB	Regional Banks
MGE Energy, Inc.	NasdaqGS:MGEE	Electric Utilities
Herman Miller, Inc.	NasdaqGS:MLHR	Office Services and Supplies
Inovalon Holdings, Inc.	NasdaqGS:INOV	Health Care Technology
Cogent Communications Holdings, Inc.	NasdaqGS:CCOI	Alternative Carriers
Steven Madden, Ltd.	NasdaqGS:SHOO	Footwear
Columbia Banking System, Inc.	NasdaqGS:COLB	Regional Banks
Acadia Healthcare Company, Inc.	NasdaqGS:ACHC	Health Care Facilities
WD-40 Company	NasdaqGS:WDFC	Household Products
First Interstate BancSystem, Inc.	NasdaqGS:FIBK	Regional Banks
Baozun Inc.	NasdaqGS:BZUN	Internet and Direct Marketing Retail
Power Integrations, Inc.	NasdaqGS:POWI	Semiconductors
Agios Pharmaceuticals, Inc.	NasdaqGS:AGIO	Biotechnology
Lattice Semiconductor Corporation	NasdaqGS:LSCC	Semiconductors
Arco Platform Limited	NasdaqGS:ARCE	Education Services
Altair Engineering Inc.	NasdaqGS:ALTR	Application Software
Premier, Inc.	NasdaqGS:PINC	Health Care Services
SVMK Inc.	NasdaqGS:SVMK	Application Software
eHealth, Inc.	NasdaqGS:EHTH	Insurance Brokers
The Carlyle Group L.P.	NasdaqGS:CG	Asset Management and Custody Banks
Novanta Inc.	NasdaqGS:NOVT	Electronic Equipment and Instruments
PotlatchDeltic Corporation	NasdaqGS:PCH	Specialized REITs
Reata Pharmaceuticals, Inc.	NasdaqGM:RETA	Pharmaceuticals
Universal Forest Products, Inc.	NasdaqGS:UFPI	Building Products
National Vision Holdings, Inc.	NasdaqGS:EYE	Specialty Stores
Independent Bank Corp.	NasdaqGS:INDB	Regional Banks
Alarm.com Holdings, Inc.	NasdaqGS:ALRM	Application Software
Simmons First National Corporation	NasdaqGS:SFNC	Regional Banks
II-VI Incorporated	NasdaqGS:IIVI	Electronic Components
Quidel Corporation	NasdaqGS:QDEL	Health Care Supplies
LivePerson, Inc.	NasdaqGS:LPSN	Application Software
SINA Corporation	NasdaqGS:SINA	Interactive Media and Services
Avis Budget Group, Inc.	NasdaqGS:CAR	Trucking
Atlantica Yield plc	NasdaqGS:AY	Renewable Electricity
Coca-Cola Consolidated, Inc.	NasdaqGS:COKE	Soft Drinks
CommScope Holding Company, Inc.	NasdaqGS:COMM	Communications Equipment
Dorman Products, Inc.	NasdaqGS:DORM	Auto Parts and Equipment
First Financial Bancorp.	NasdaqGS:FFBC	Regional Banks
MakeMyTrip Limited	NasdaqGS:MMYT	Internet and Direct Marketing Retail
Allegiant Travel Company	NasdaqGS:ALGT	Airlines
Acceleron Pharma Inc.	NasdaqGM:XLRN	Biotechnology
Halozyme Therapeutics, Inc.	NasdaqGS:HALO	Biotechnology
ExlService Holdings, Inc.	NasdaqGS:EXLS	Data Processing and Outsourced Services
Builders FirstSource, Inc.	NasdaqGS:BLDR	Building Products
The Hain Celestial Group, Inc.	NasdaqGS:HAIN	Packaged Foods and Meats
AAON, Inc.	NasdaqGS:AAON	Building Products
Pattern Energy Group Inc.	NasdaqGS:PEGI	Renewable Electricity
Natera, Inc.	NasdaqGS:NTRA	Biotechnology
Jack in the Box Inc.	NasdaqGS:JACK	Restaurants
Stitch Fix, Inc.	NasdaqGS:SFIX	Internet and Direct Marketing Retail
Afya Limited	NasdaqGS:AFYA	Education Services
Brooks Automation, Inc.	NasdaqGS:BRKS	Semiconductor Equipment
Trustmark Corporation	NasdaqGS:TRMK	Regional Banks
Chart Industries, Inc.	NasdaqGS:GTLS	Industrial Machinery
Tenable Holdings, Inc.	NasdaqGS:TENB	Systems Software
International Bancshares Corporation	NasdaqGS:IBOC	Regional Banks
WSFS Financial Corporation	NasdaqGS:WSFS	Thrifts and Mortgage Finance
Independent Bank Group, Inc.	NasdaqGS:IBTX	Regional Banks
Intercept Pharmaceuticals, Inc.	NasdaqGS:ICPT	Biotechnology
First Midwest Bancorp, Inc.	NasdaqGS:FMBI	Regional Banks
Werner Enterprises, Inc.	NasdaqGS:WERN	Trucking
Casella Waste Systems, Inc.	NasdaqGS:CWST	Environmental and Facilities Services
Innospec Inc.	NasdaqGS:IOSP	Specialty Chemicals
CareTrust REIT, Inc.	NasdaqGS:CTRE	Health Care REITs
The Simply Good Foods Company	NasdaqCM:SMPL	Packaged Foods and Meats
United Community Banks, Inc.	NasdaqGS:UCBI	Regional Banks
Yunji Inc.	NasdaqGM:YJ	Internet and Direct Marketing Retail
Amkor Technology, Inc.	NasdaqGS:AMKR	Semiconductor Equipment
Senior Housing Properties Trust	NasdaqGS:SNH	Health Care REITs
Penn National Gaming, Inc.	NasdaqGS:PENN	Casinos and Gaming
Virtu Financial, Inc.	NasdaqGS:VIRT	Investment Banking and Brokerage
Zogenix, Inc.	NasdaqGM:ZGNX	Pharmaceuticals
TTEC Holdings, Inc.	NasdaqGS:TTEC	Data Processing and Outsourced Services
Varonis Systems, Inc.	NasdaqGS:VRNS	Systems Software
Xencor, Inc.	NasdaqGM:XNCR	Biotechnology
Inter Parfums, Inc.	NasdaqGS:IPAR	Personal Products
Portola Pharmaceuticals, Inc.	NasdaqGS:PTLA	Biotechnology
Franklin Electric Co., Inc.	NasdaqGS:FELE	Industrial Machinery
Sprouts Farmers Market, Inc.	NasdaqGS:SFM	Food Retail
Weight Watchers International, Inc.	NasdaqGS:WW	Specialized Consumer Services
Retail Opportunity Investments Corp.	NasdaqGS:ROIC	Retail REITs
Sanmina Corporation	NasdaqGS:SANM	Electronic Manufacturing Services
Otter Tail Corporation	NasdaqGS:OTTR	Electric Utilities
Akcea Therapeutics, Inc.	NasdaqGS:AKCA	Biotechnology
Tower Semiconductor Ltd.	NasdaqGS:TSEM	Semiconductors
Urban Outfitters, Inc.	NasdaqGS:URBN	Apparel Retail
uniQure N.V.	NasdaqGS:QURE	Biotechnology
Alliance Resource Partners, L.P.	NasdaqGS:ARLP	Coal and Consumable Fuels
Saia, Inc.	NasdaqGS:SAIA	Trucking
SunPower Corporation	NasdaqGS:SPWR	Semiconductors
National Beverage Corp.	NasdaqGS:FIZZ	Soft Drinks
Merit Medical Systems, Inc.	NasdaqGS:MMSI	Health Care Supplies
Beacon Roofing Supply, Inc.	NasdaqGS:BECN	Trading Companies and Distributors
Kratos Defense & Security Solutions, Inc.	NasdaqGS:KTOS	Aerospace and Defense
Kinsale Capital Group, Inc.	NasdaqGS:KNSL	Property and Casualty Insurance
Commvault Systems, Inc.	NasdaqGS:CVLT	Systems Software
International Speedway Corporation	NasdaqGS:ISCA	Leisure Facilities
Renasant Corporation	NasdaqGS:RNST	Regional Banks
TowneBank	NasdaqGS:TOWN	Regional Banks
OSI Systems, Inc.	NasdaqGS:OSIS	Electronic Equipment and Instruments
Cal-Maine Foods, Inc.	NasdaqGS:CALM	Packaged Foods and Meats
iRhythm Technologies, Inc.	NasdaqGS:IRTC	Health Care Equipment
LegacyTexas Financial Group, Inc.	NasdaqGS:LTXB	Regional Banks
Sunrun Inc.	NasdaqGS:RUN	Electrical Components and Equipment
Diodes Incorporated	NasdaqGS:DIOD	Semiconductors
WesBanco, Inc.	NasdaqGS:WSBC	Regional Banks
iRobot Corporation	NasdaqGS:IRBT	Household Appliances
Insight Enterprises, Inc.	NasdaqGS:NSIT	Technology Distributors
Denali Therapeutics Inc.	NasdaqGS:DNLI	Biotechnology
Viper Energy Partners LP	NasdaqGS:VNOM	Oil and Gas Exploration and Production
Banner Corporation	NasdaqGS:BANR	Regional Banks
SPS Commerce, Inc.	NasdaqGS:SPSC	Application Software
Bottomline Technologies (de), Inc.	NasdaqGS:EPAY	Application Software
Advanced Energy Industries, Inc.	NasdaqGS:AEIS	Semiconductor Equipment
NMI Holdings, Inc.	NasdaqGM:NMIH	Thrifts and Mortgage Finance
Patterson-UTI Energy, Inc.	NasdaqGS:PTEN	Oil and Gas Drilling
First Merchants Corporation	NasdaqGS:FRME	Regional Banks
Bandwidth Inc.	NasdaqGS:BAND	Alternative Carriers
Ligand Pharmaceuticals Incorporated	NasdaqGM:LGND	Biotechnology
Capitol Federal Financial, Inc.	NasdaqGS:CFFN	Thrifts and Mortgage Finance
LexinFintech Holdings Ltd.	NasdaqGM:LX	Consumer Finance
BancFirst Corporation	NasdaqGS:BANF	Regional Banks
Apellis Pharmaceuticals, Inc.	NasdaqGS:APLS	Biotechnology
Luokung Technology Corp.	NasdaqCM:LKCO	Interactive Media and Services
Brookfield Property REIT Inc.	NasdaqGS:BPR	Retail REITs
PriceSmart, Inc.	NasdaqGS:PSMT	Hypermarkets and Super Centers
The Cheesecake Factory Incorporated	NasdaqGS:CAKE	Restaurants
PDC Energy, Inc.	NasdaqGS:PDCE	Oil and Gas Exploration and Production
Hope Bancorp, Inc.	NasdaqGS:HOPE	Regional Banks
Northwest Bancshares, Inc.	NasdaqGS:NWBI	Thrifts and Mortgage Finance
Pacific Premier Bancorp, Inc.	NasdaqGS:PPBI	Regional Banks
Progress Software Corporation	NasdaqGS:PRGS	Systems Software
Pacira BioSciences, Inc.	NasdaqGS:PCRX	Pharmaceuticals
Scientific Games Corporation	NasdaqGS:SGMS	Casinos and Gaming
BGC Partners, Inc.	NasdaqGS:BGCP	Investment Banking and Brokerage
Redfin Corporation	NasdaqGS:RDFN	Real Estate Services
Fanhua Inc.	NasdaqGS:FANH	Insurance Brokers
Healthcare Services Group, Inc.	NasdaqGS:HCSG	Diversified Support Services
Shutterfly, Inc.	NasdaqGS:SFLY	Internet and Direct Marketing Retail
LGI Homes, Inc.	NasdaqGS:LGIH	Homebuilding
Crocs, Inc.	NasdaqGS:CROX	Footwear
Forward Air Corporation	NasdaqGS:FWRD	Air Freight and Logistics
Patterson Companies, Inc.	NasdaqGS:PDCO	Health Care Distributors
Visteon Corporation	NasdaqGS:VC	Auto Parts and Equipment
Uniti Group Inc.	NasdaqGS:UNIT	Specialized REITs
trivago N.V.	NasdaqGS:TRVG	Interactive Media and Services
Columbia Financial, Inc.	NasdaqGS:CLBK	Thrifts and Mortgage Finance
NetScout Systems, Inc.	NasdaqGS:NTCT	Communications Equipment
Plexus Corp.	NasdaqGS:PLXS	Electronic Manufacturing Services
Forescout Technologies, Inc.	NasdaqGM:FSCT	Systems Software
Magellan Health, Inc.	NasdaqGS:MGLN	Managed Health Care
Pluralsight, Inc.	NasdaqGS:PS	Application Software
Shenandoah Telecommunications Company	NasdaqGS:SHEN	Wireless Telecommunication Services
Upwork Inc.	NasdaqGS:UPWK	Human Resource and Employment Services
BMC Stock Holdings, Inc.	NasdaqGS:BMCH	Trading Companies and Distributors
Westamerica Bancorporation	NasdaqGS:WABC	Regional Banks
Heartland Financial USA, Inc.	NasdaqGS:HTLF	Regional Banks
Cavco Industries, Inc.	NasdaqGS:CVCO	Homebuilding
Health Catalyst, Inc.	NasdaqGS:HCAT	Health Care Technology
Newmark Group, Inc.	NasdaqGS:NMRK	Real Estate Services
ServisFirst Bancshares, Inc.	NasdaqGS:SFBS	Regional Banks
Change Healthcare Inc.	NasdaqGS:CHNG	Health Care Technology
Altra Industrial Motion Corp.	NasdaqGS:AIMC	Industrial Machinery
Cardiovascular Systems, Inc.	NasdaqGS:CSII	Health Care Equipment
Tricida, Inc.	NasdaqGS:TCDA	Pharmaceuticals
Heartland Express, Inc.	NasdaqGS:HTLD	Trucking
Allscripts Healthcare Solutions, Inc.	NasdaqGS:MDRX	Health Care Technology
Audentes Therapeutics, Inc.	NasdaqGM:BOLD	Biotechnology
CorVel Corporation	NasdaqGS:CRVL	Health Care Services
Calavo Growers, Inc.	NasdaqGS:CVGW	Packaged Foods and Meats
CSG Systems International, Inc.	NasdaqGS:CSGS	Data Processing and Outsourced Services
InterDigital, Inc.	NasdaqGS:IDCC	Communications Equipment
Carbon Black, Inc.	NasdaqGS:CBLK	Systems Software
Hailiang Education Group Inc.	NasdaqGM:HLG	Education Services
National Research Corporation	NasdaqGS:NRC	Health Care Services
McGrath RentCorp	NasdaqGS:MGRC	Diversified Support Services
NBT Bancorp Inc.	NasdaqGS:NBTB	Regional Banks
WillScot Corporation	NasdaqCM:WSC	Construction and Engineering
Hostess Brands, Inc.	NasdaqCM:TWNK	Packaged Foods and Meats
ICF International, Inc.	NasdaqGS:ICFI	Research and Consulting Services
Core-Mark Holding Company, Inc.	NasdaqGS:CORE	Distributors
Hamilton Lane Incorporated	NasdaqGS:HLNE	Asset Management and Custody Banks
Career Education Corporation	NasdaqGS:CECO	Education Services
The RealReal, Inc.	NasdaqGS:REAL	Internet and Direct Marketing Retail
Kaiser Aluminum Corporation	NasdaqGS:KALU	Aluminum
Supernus Pharmaceuticals, Inc.	NasdaqGM:SUPN	Pharmaceuticals
Ambarella, Inc.	NasdaqGS:AMBA	Semiconductors
Ironwood Pharmaceuticals, Inc.	NasdaqGS:IRWD	Biotechnology
360 Finance, Inc.	NasdaqGM:QFIN	Consumer Finance
PRA Group, Inc.	NasdaqGS:PRAA	Consumer Finance
Safety Insurance Group, Inc.	NasdaqGS:SAFT	Property and Casualty Insurance
New York Mortgage Trust, Inc.	NasdaqGS:NYMT	Mortgage REITs
Papa John's International, Inc.	NasdaqGS:PZZA	Restaurants
Ra Pharmaceuticals, Inc.	NasdaqGM:RARX	Biotechnology
James River Group Holdings, Ltd.	NasdaqGS:JRVR	Property and Casualty Insurance
The Liberty Braves Group	NasdaqGS:BATR.K	Movies and Entertainment
Bloomin' Brands, Inc.	NasdaqGS:BLMN	Restaurants
REGENXBIO Inc.	NasdaqGS:RGNX	Biotechnology
Insmed Incorporated	NasdaqGS:INSM	Biotechnology
State Auto Financial Corporation	NasdaqGS:STFC	Property and Casualty Insurance
Enanta Pharmaceuticals, Inc.	NasdaqGS:ENTA	Biotechnology
MicroStrategy Incorporated	NasdaqGS:MSTR	Application Software
Heron Therapeutics, Inc.	NasdaqCM:HRTX	Biotechnology
So-Young International Inc.	NasdaqGM:SY	Interactive Media and Services
Rent-A-Center, Inc.	NasdaqGS:RCII	Computer and Electronics Retail
Freshpet, Inc.	NasdaqGM:FRPT	Packaged Foods and Meats
Cray Inc.	NasdaqGS:CRAY	Technology Hardware, Storage and Peripherals
Mobile Mini, Inc.	NasdaqGS:MINI	Diversified Support Services
Dave & Buster's Entertainment, Inc.	NasdaqGS:PLAY	Restaurants
Groupon, Inc.	NasdaqGS:GRPN	Internet and Direct Marketing Retail
STAAR Surgical Company	NasdaqGM:STAA	Health Care Supplies
BioTelemetry, Inc.	NasdaqGS:BEAT	Health Care Services
Hub Group, Inc.	NasdaqGS:HUBG	Air Freight and Logistics
Corcept Therapeutics Incorporated	NasdaqCM:CORT	Pharmaceuticals
First Busey Corporation	NasdaqGS:BUSE	Regional Banks
Rush Enterprises, Inc.	NasdaqGS:RUSH.B	Trading Companies and Distributors
NIC Inc.	NasdaqGS:EGOV	Data Processing and Outsourced Services
Atrion Corporation	NasdaqGS:ATRI	Health Care Supplies
Industrial Logistics Properties Trust	NasdaqGS:ILPT	Industrial REITs
Madrigal Pharmaceuticals, Inc.	NasdaqCM:MDGL	Biotechnology
R1 RCM Inc.	NasdaqGS:RCM	Health Care Services
AnaptysBio, Inc.	NasdaqGS:ANAB	Biotechnology
Eagle Bancorp, Inc.	NasdaqCM:EGBN	Regional Banks
Helios Technologies, Inc.	NasdaqGS:HLIO	Industrial Machinery
American Woodmark Corporation	NasdaqGS:AMWD	Building Products
US Ecology, Inc.	NasdaqGS:ECOL	Environmental and Facilities Services
Sangamo Therapeutics, Inc.	NasdaqGS:SGMO	Biotechnology
Gibraltar Industries, Inc.	NasdaqGS:ROCK	Building Products
Turning Point Therapeutics, Inc.	NasdaqGS:TPTX	Biotechnology
Denny's Corporation	NasdaqCM:DENN	Restaurants
Coherus BioSciences, Inc.	NasdaqGM:CHRS	Biotechnology
Rambus Inc.	NasdaqGS:RMBS	Semiconductors
Kulicke and Soffa Industries, Inc.	NasdaqGS:KLIC	Semiconductor Equipment
Red Rock Resorts, Inc.	NasdaqGS:RRR	Casinos and Gaming
The Children's Place, Inc.	NasdaqGS:PLCE	Apparel Retail
TriMas Corporation	NasdaqGS:TRS	Industrial Machinery
Golar LNG Limited	NasdaqGS:GLNG	Oil and Gas Storage and Transportation
MACOM Technology Solutions Holdings, Inc.	NasdaqGS:MTSI	Semiconductors
Tabula Rasa HealthCare, Inc.	NasdaqGM:TRHC	Health Care Technology
Seacoast Banking Corporation of Florida	NasdaqGS:SBCF	Regional Banks
Canadian Solar Inc.	NasdaqGS:CSIQ	Semiconductors
Office Properties Income Trust	NasdaqGS:OPI	Office REITs
Eidos Therapeutics, Inc.	NasdaqGS:EIDX	Biotechnology
Stratasys Ltd.	NasdaqGS:SSYS	Technology Hardware, Storage and Peripherals
Huron Consulting Group Inc.	NasdaqGS:HURN	Research and Consulting Services
Sleep Number Corporation	NasdaqGS:SNBR	Homefurnishing Retail
Central Garden & Pet Company	NasdaqGS:CENT	Household Products
Gossamer Bio, Inc.	NasdaqGS:GOSS	Biotechnology
Orchard Therapeutics plc	NasdaqGS:ORTX	Biotechnology
Amerisafe, Inc.	NasdaqGS:AMSF	Property and Casualty Insurance
Gentherm Incorporated	NasdaqGS:THRM	Auto Parts and Equipment
American Finance Trust, Inc.	NasdaqGS:AFIN	Retail REITs
Criteo S.A.	NasdaqGS:CRTO	Advertising
Tellurian Inc.	NasdaqCM:TELL	Oil and Gas Exploration and Production
Veracyte, Inc.	NasdaqGM:VCYT	Biotechnology
Qiwi plc	NasdaqGS:QIWI	Data Processing and Outsourced Services
Veritex Holdings, Inc.	NasdaqGM:VBTX	Regional Banks
FormFactor, Inc.	NasdaqGS:FORM	Semiconductor Equipment
Alector, Inc.	NasdaqGS:ALEC	Biotechnology
Phibro Animal Health Corporation	NasdaqGM:PAHC	Pharmaceuticals
Sirius International Insurance Group, Ltd.	NasdaqGS:SG	Reinsurance
AeroVironment, Inc.	NasdaqGS:AVAV	Aerospace and Defense
Silk Road Medical, Inc	NasdaqGM:SILK	Health Care Supplies
Air Transport Services Group, Inc.	NasdaqGS:ATSG	Air Freight and Logistics
Sandy Spring Bancorp, Inc.	NasdaqGS:SASR	Regional Banks
City Holding Company	NasdaqGS:CHCO	Regional Banks
1-800-FLOWERS.COM, Inc.	NasdaqGS:FLWS	Internet and Direct Marketing Retail
S&T Bancorp, Inc.	NasdaqGS:STBA	Regional Banks
Sonos, Inc.	NasdaqGS:SONO	Consumer Electronics
Fate Therapeutics, Inc.	NasdaqGM:FATE	Biotechnology
Centennial Resource Development, Inc.	NasdaqCM:CDEV	Oil and Gas Exploration and Production
Hawaiian Holdings, Inc.	NasdaqGS:HA	Airlines
Radware Ltd.	NasdaqGS:RDWR	Communications Equipment
Encore Capital Group, Inc.	NasdaqGS:ECPG	Consumer Finance
Editas Medicine, Inc.	NasdaqGS:EDIT	Biotechnology
AtriCure, Inc.	NasdaqGM:ATRC	Health Care Equipment
United Fire Group, Inc.	NasdaqGS:UFCS	Property and Casualty Insurance
ShockWave Medical, Inc.	NasdaqGS:SWAV	Health Care Equipment
Aimmune Therapeutics, Inc.	NasdaqGS:AIMT	Biotechnology
Raven Industries, Inc.	NasdaqGS:RAVN	Industrial Conglomerates
Talend S.A.	NasdaqGM:TLND	Systems Software
Central European Media Enterprises Ltd.	NasdaqGS:CETV	Broadcasting
Loral Space & Communications Inc.	NasdaqGS:LORL	Cable and Satellite
Ebix, Inc.	NasdaqGS:EBIX	Application Software
Silicon Motion Technology Corporation	NasdaqGS:SIMO	Semiconductors
MTS Systems Corporation	NasdaqGS:MTSC	Electronic Equipment and Instruments
Scholastic Corporation	NasdaqGS:SCHL	Publishing
Sykes Enterprises, Incorporated	NasdaqGS:SYKE	Data Processing and Outsourced Services
Theravance Biopharma, Inc.	NasdaqGM:TBPH	Pharmaceuticals
Vicor Corporation	NasdaqGS:VICR	Electrical Components and Equipment
Victory Capital Holdings, Inc.	NasdaqGS:VCTR	Asset Management and Custody Banks
Perficient, Inc.	NasdaqGS:PRFT	IT Consulting and Other Services
Innoviva, Inc.	NasdaqGS:INVA	Pharmaceuticals
G-III Apparel Group, Ltd.	NasdaqGS:GIII	Apparel, Accessories and Luxury Goods
1st Source Corporation	NasdaqGS:SRCE	Regional Banks
Odonate Therapeutics, Inc.	NasdaqGS:ODT	Pharmaceuticals
The Chefs' Warehouse, Inc.	NasdaqGS:CHEF	Food Distributors
Blucora, Inc.	NasdaqGS:BCOR	Asset Management and Custody Banks
OceanFirst Financial Corp.	NasdaqGS:OCFC	Thrifts and Mortgage Finance
Focus Financial Partners Inc.	NasdaqGS:FOCS	Asset Management and Custody Banks
Encore Wire Corporation	NasdaqGS:WIRE	Electrical Components and Equipment
Southside Bancshares, Inc.	NasdaqGS:SBSI	Regional Banks
TTM Technologies, Inc.	NasdaqGS:TTMI	Electronic Manufacturing Services
Intrexon Corporation	NasdaqGS:XON	Biotechnology
Synaptics Incorporated	NasdaqGS:SYNA	Semiconductors
Momenta Pharmaceuticals, Inc.	NasdaqGS:MNTA	Biotechnology
Futu Holdings Limited	NasdaqGM:FHL	Investment Banking and Brokerage
Kearny Financial Corp.	NasdaqGS:KRNY	Thrifts and Mortgage Finance
TriCo Bancshares	NasdaqGS:TCBK	Regional Banks
Brookline Bancorp, Inc.	NasdaqGS:BRKL	Regional Banks
G1 Therapeutics, Inc.	NasdaqGS:GTHX	Biotechnology
ArQule, Inc.	NasdaqGM:ARQL	Biotechnology
Meta Financial Group, Inc.	NasdaqGS:CASH	Thrifts and Mortgage Finance
Athenex, Inc.	NasdaqGS:ATNX	Biotechnology
Kornit Digital Ltd.	NasdaqGS:KRNT	Industrial Machinery
Kelly Services, Inc.	NasdaqGS:KELY.A	Human Resource and Employment Services
Presidio, Inc.	NasdaqGS:PSDO	IT Consulting and Other Services
OPKO Health, Inc.	NasdaqGS:OPK	Biotechnology
ePlus inc.	NasdaqGS:PLUS	Technology Distributors
World Acceptance Corporation	NasdaqGS:WRLD	Consumer Finance
Lakeland Financial Corporation	NasdaqGS:LKFN	Regional Banks
Addus HomeCare Corporation	NasdaqGS:ADUS	Health Care Services
Cara Therapeutics, Inc.	NasdaqGM:CARA	Pharmaceuticals
Aerie Pharmaceuticals, Inc.	NasdaqGM:AERI	Pharmaceuticals
Opera Limited	NasdaqGS:OPRA	Application Software
Upland Software, Inc.	NasdaqGM:UPLD	Application Software
First Bancorp	NasdaqGS:FBNC	Regional Banks
Natus Medical Incorporated	NasdaqGS:NTUS	Health Care Equipment
Trupanion, Inc.	NasdaqGM:TRUP	Life and Health Insurance
Enterprise Financial Services Corp	NasdaqGS:EFSC	Regional Banks
Radius Health, Inc.	NasdaqGM:RDUS	Biotechnology
Bed Bath & Beyond Inc.	NasdaqGS:BBBY	Homefurnishing Retail
CareDx, Inc	NasdaqGM:CDNA	Biotechnology
Marten Transport, Ltd.	NasdaqGS:MRTN	Trucking
The E.W. Scripps Company	NasdaqGS:SSP	Broadcasting
Epizyme, Inc.	NasdaqGS:EPZM	Biotechnology
CSW Industrials, Inc.	NasdaqGS:CSWI	Building Products
Virtusa Corporation	NasdaqGS:VRTU	IT Consulting and Other Services
NETGEAR, Inc.	NasdaqGS:NTGR	Communications Equipment
Orthofix Medical Inc.	NasdaqGS:OFIX	Health Care Equipment
Sundial Growers Inc.	NasdaqGS:SNDL	Pharmaceuticals
Qutoutiao Inc.	NasdaqGS:QTT	Interactive Media and Services
NextGen Healthcare, Inc.	NasdaqGS:NXGN	Health Care Technology
Esperion Therapeutics, Inc.	NasdaqGM:ESPR	Biotechnology
Apogee Enterprises, Inc.	NasdaqGS:APOG	Building Products
Xperi Corporation	NasdaqGS:XPER	Semiconductor Equipment
Primoris Services Corporation	NasdaqGS:PRIM	Construction and Engineering
Heritage Financial Corporation	NasdaqGS:HFWA	Regional Banks
Varex Imaging Corporation	NasdaqGS:VREX	Health Care Equipment
Stamps.com Inc.	NasdaqGS:STMP	Internet and Direct Marketing Retail
Patrick Industries, Inc.	NasdaqGS:PATK	Building Products
Matthews International Corporation	NasdaqGS:MATW	Diversified Support Services
Middlesex Water Company	NasdaqGS:MSEX	Water Utilities
Inogen, Inc.	NasdaqGS:INGN	Health Care Equipment
Amphastar Pharmaceuticals, Inc.	NasdaqGS:AMPH	Pharmaceuticals
Principia Biopharma Inc.	NasdaqGS:PRNB	Biotechnology
PC Connection, Inc.	NasdaqGS:CNXN	Technology Distributors
Hollysys Automation Technologies Ltd.	NasdaqGS:HOLI	Electronic Equipment and Instruments
Extreme Networks, Inc.	NasdaqGS:EXTR	Communications Equipment
Axonics Modulation Technologies, Inc.	NasdaqGS:AXNX	Health Care Equipment
2U, Inc.	NasdaqGS:TWOU	Application Software
CIM Commercial Trust Corporation	NasdaqGM:CMCT	Office REITs
Tactile Systems Technology, Inc.	NasdaqGM:TCMD	Health Care Equipment
EVO Payments, Inc.	NasdaqGM:EVOP	Data Processing and Outsourced Services
Luminex Corporation	NasdaqGS:LMNX	Life Sciences Tools and Services
Republic Bancorp, Inc.	NasdaqGS:RBCA.A	Regional Banks
Twist Bioscience Corporation	NasdaqGS:TWST	Biotechnology
Playa Hotels & Resorts N.V.	NasdaqGS:PLYA	Hotels, Resorts and Cruise Lines
Mesa Laboratories, Inc.	NasdaqGS:MLAB	Health Care Equipment
OneSpaWorld Holdings Limited	NasdaqCM:OSW	Specialized Consumer Services
H&E Equipment Services, Inc.	NasdaqGS:HEES	Trading Companies and Distributors
Accelerate Diagnostics, Inc.	NasdaqCM:AXDX	Life Sciences Tools and Services
National Western Life Group, Inc.	NasdaqGS:NWLI	Life and Health Insurance
Rubius Therapeutics, Inc.	NasdaqGS:RUBY	Biotechnology
The Michaels Companies, Inc.	NasdaqGS:MIK	Specialty Stores
Stoke Therapeutics, Inc.	NasdaqGS:STOK	Biotechnology
Materialise NV	NasdaqGS:MTLS	Application Software
Lindblad Expeditions Holdings, Inc.	NasdaqCM:LIND	Hotels, Resorts and Cruise Lines
HeadHunter Group PLC	NasdaqGS:HHR	Human Resource and Employment Services
Dicerna Pharmaceuticals, Inc.	NasdaqGS:DRNA	Biotechnology
Carrizo Oil & Gas, Inc.	NasdaqGS:CRZO	Oil and Gas Exploration and Production
NGM Biopharmaceuticals, Inc.	NasdaqGS:NGM	Pharmaceuticals
HealthStream, Inc.	NasdaqGS:HSTM	Health Care Technology
SecureWorks Corp.	NasdaqGS:SCWX	Systems Software
Meridian Bancorp, Inc.	NasdaqGS:EBSB	Thrifts and Mortgage Finance
John B. Sanfilippo & Son, Inc.	NasdaqGS:JBSS	Packaged Foods and Meats
Astronics Corporation	NasdaqGS:ATRO	Aerospace and Defense
Omeros Corporation	NasdaqGM:OMER	Pharmaceuticals
Deciphera Pharmaceuticals, Inc.	NasdaqGS:DCPH	Biotechnology
Sapiens International Corporation N.V.	NasdaqCM:SPNS	Application Software
Overstock.com, Inc.	NasdaqGM:OSTK	Internet and Direct Marketing Retail
ZIOPHARM Oncology, Inc.	NasdaqCM:ZIOP	Biotechnology
Spectrum Pharmaceuticals, Inc.	NasdaqGS:SPPI	Biotechnology
Tivity Health, Inc.	NasdaqGS:TVTY	Health Care Services
NanoString Technologies, Inc.	NasdaqGM:NSTG	Life Sciences Tools and Services
Lantheus Holdings, Inc.	NasdaqGM:LNTH	Health Care Supplies
Kura Oncology, Inc.	NasdaqGS:KURA	Biotechnology
Star Bulk Carriers Corp.	NasdaqGS:SBLK	Marine
Axsome Therapeutics, Inc.	NasdaqGM:AXSM	Pharmaceuticals
MGP Ingredients, Inc.	NasdaqGS:MGPI	Distillers and Vintners
Pacific Biosciences of California, Inc.	NasdaqGS:PACB	Life Sciences Tools and Services
Office Depot, Inc.	NasdaqGS:ODP	Specialty Stores
NV5 Global, Inc.	NasdaqCM:NVEE	Construction and Engineering
Boston Private Financial Holdings, Inc.	NasdaqGS:BPFH	Regional Banks
FARO Technologies, Inc.	NasdaqGS:FARO	Electronic Equipment and Instruments
ATN International, Inc.	NasdaqGS:ATNI	Integrated Telecommunication Services
ANI Pharmaceuticals, Inc.	NasdaqGM:ANIP	Pharmaceuticals
Benefitfocus, Inc.	NasdaqGM:BNFT	Application Software
Intellia Therapeutics, Inc.	NasdaqGM:NTLA	Biotechnology
Connecticut Water Service, Inc.	NasdaqGS:CTWS	Water Utilities
Ambac Financial Group, Inc.	NasdaqGS:AMBC	Property and Casualty Insurance
Morphic Holding, Inc.	NasdaqGM:MORF	Biotechnology
Stock Yards Bancorp, Inc.	NasdaqGS:SYBT	Regional Banks
Arvinas, Inc.	NasdaqGS:ARVN	Pharmaceuticals
Codexis, Inc.	NasdaqGS:CDXS	Life Sciences Tools and Services
The Andersons, Inc.	NasdaqGS:ANDE	Food Distributors
Monarch Casino & Resort, Inc.	NasdaqGS:MCRI	Casinos and Gaming
Washington Trust Bancorp, Inc.	NasdaqGS:WASH	Regional Banks
German American Bancorp, Inc.	NasdaqGS:GABC	Regional Banks
iHeartMedia, Inc.	NasdaqGS:IHRT	Broadcasting
ScanSource, Inc.	NasdaqGS:SCSC	Technology Distributors
Y-mAbs Therapeutics, Inc.	NasdaqGS:YMAB	Biotechnology
Mr. Cooper Group Inc.	NasdaqCM:COOP	Thrifts and Mortgage Finance
WisdomTree Investments, Inc.	NasdaqGS:WETF	Asset Management and Custody Banks
Great Southern Bancorp, Inc.	NasdaqGS:GSBC	Regional Banks
Columbus McKinnon Corporation	NasdaqGS:CMCO	Industrial Machinery
Infinera Corporation	NasdaqGS:INFN	Communications Equipment
Liberty TripAdvisor Holdings, Inc.	NasdaqGS:LTRP.A	Interactive Media and Services
MeiraGTx Holdings plc	NasdaqGS:MGTX	Biotechnology
Cryoport, Inc.	NasdaqCM:CYRX	Health Care Equipment
Impinj, Inc.	NasdaqGS:PI	Semiconductors
PetIQ, Inc.	NasdaqGS:PETQ	Health Care Distributors
Vericel Corporation	NasdaqCM:VCEL	Biotechnology
21Vianet Group, Inc.	NasdaqGS:VNET	Internet Services and Infrastructure
Cytokinetics, Incorporated	NasdaqGS:CYTK	Biotechnology
Monotype Imaging Holdings Inc.	NasdaqGS:TYPE	Application Software
Nova Measuring Instruments Ltd.	NasdaqGS:NVMI	Semiconductor Equipment
Retrophin, Inc.	NasdaqGM:RTRX	Biotechnology
Rattler Midstream LP	NasdaqGS:RTLR	Oil and Gas Storage and Transportation
Kforce Inc.	NasdaqGS:KFRC	Human Resource and Employment Services
Alder BioPharmaceuticals, Inc.	NasdaqGM:ALDR	Biotechnology
Vanda Pharmaceuticals Inc.	NasdaqGM:VNDA	Biotechnology
EMC Insurance Group Inc.	NasdaqGS:EMCI	Property and Casualty Insurance
Golden Ocean Group Limited	NasdaqGS:GOGL	Marine
Eagle Pharmaceuticals, Inc.	NasdaqGM:EGRX	Biotechnology
Anika Therapeutics, Inc.	NasdaqGS:ANIK	Biotechnology
SP Plus Corporation	NasdaqGS:SP	Environmental and Facilities Services
Origin Bancorp, Inc.	NasdaqGS:OBNK	Regional Banks
Target Hospitality Corp.	NasdaqCM:TH	Hotels, Resorts and Cruise Lines
Lakeland Bancorp, Inc.	NasdaqGS:LBAI	Regional Banks
Carolina Financial Corporation	NasdaqCM:CARO	Regional Banks
Preferred Bank	NasdaqGS:PFBC	Regional Banks
Triumph Bancorp, Inc.	NasdaqGS:TBK	Regional Banks
Krystal Biotech, Inc.	NasdaqCM:KRYS	Biotechnology
BJ's Restaurants, Inc.	NasdaqGS:BJRI	Restaurants
Northfield Bancorp, Inc. (Staten Island, NY)	NasdaqGS:NFBK	Thrifts and Mortgage Finance
TrustCo Bank Corp NY	NasdaqGS:TRST	Thrifts and Mortgage Finance
Voyager Therapeutics, Inc.	NasdaqGS:VYGR	Biotechnology
Univest Financial Corporation	NasdaqGS:UVSP	Regional Banks
Mercer International Inc.	NasdaqGS:MERC	Paper Products
RadNet, Inc.	NasdaqGM:RDNT	Health Care Services
Atlas Air Worldwide Holdings, Inc.	NasdaqGS:AAWW	Air Freight and Logistics
Omega Flex, Inc.	NasdaqGM:OFLX	Industrial Machinery
MobileIron, Inc.	NasdaqGS:MOBL	Application Software
Opus Bank	NasdaqGS:OPB	Regional Banks
The RMR Group Inc.	NasdaqCM:RMR	Diversified Real Estate Activities
TherapeuticsMD, Inc.	NasdaqGS:TXMD	Pharmaceuticals
Adverum Biotechnologies, Inc.	NasdaqGM:ADVM	Biotechnology
QAD Inc.	NasdaqGS:QADA	Application Software
Cortexyme, Inc.	NasdaqGS:CRTX	Biotechnology
Cardlytics, Inc.	NasdaqGM:CDLX	Advertising
Oritani Financial Corp.	NasdaqGS:ORIT	Thrifts and Mortgage Finance
Anterix Inc.	NasdaqCM:ATEX	Alternative Carriers
Horizon Bancorp, Inc.	NasdaqGS:HBNC	Regional Banks
Rhythm Pharmaceuticals, Inc.	NasdaqGM:RYTM	Biotechnology
Live Oak Bancshares, Inc.	NasdaqGS:LOB	Regional Banks
Uxin Limited	NasdaqGS:UXIN	Internet and Direct Marketing Retail
Cerus Corporation	NasdaqGM:CERS	Health Care Supplies
U.S. Concrete, Inc.	NasdaqCM:USCR	Construction Materials
ConnectOne Bancorp, Inc.	NasdaqGS:CNOB	Regional Banks
Glu Mobile Inc.	NasdaqGS:GLUU	Interactive Home Entertainment
Wave Life Sciences Ltd.	NasdaqGM:WVE	Pharmaceuticals
AngioDynamics, Inc.	NasdaqGS:ANGO	Health Care Equipment
Akero Therapeutics, Inc.	NasdaqGS:AKRO	Biotechnology
Construction Partners, Inc.	NasdaqGS:ROAD	Construction and Engineering
Community Trust Bancorp, Inc.	NasdaqGS:CTBI	Regional Banks
ArcBest Corporation	NasdaqGS:ARCB	Trucking
CBTX, Inc.	NasdaqGS:CBTX	Regional Banks
Dime Community Bancshares, Inc.	NasdaqGS:DCOM	Thrifts and Mortgage Finance
Funko, Inc.	NasdaqGS:FNKO	Distributors
Atara Biotherapeutics, Inc.	NasdaqGS:ATRA	Biotechnology
Cass Information Systems, Inc.	NasdaqGS:CASS	Data Processing and Outsourced Services
Golar LNG Partners LP	NasdaqGS:GMLP	Oil and Gas Storage and Transportation
The Providence Service Corporation	NasdaqGS:PRSC	Health Care Services
Bryn Mawr Bank Corporation	NasdaqGS:BMTC	Regional Banks
Domo, Inc.	NasdaqGM:DOMO	Application Software
Amerant Bancorp Inc.	NasdaqGS:AMTB	Regional Banks
National Energy Services Reunited Corp.	NasdaqCM:NESR	Oil and Gas Equipment and Services
Nanometrics Incorporated	NasdaqGS:NANO	Semiconductor Equipment
INTL FCStone Inc.	NasdaqGS:INTL	Investment Banking and Brokerage
Quotient Limited	NasdaqGM:QTNT	Health Care Supplies
MacroGenics, Inc.	NasdaqGS:MGNX	Biotechnology
Endurance International Group Holdings, Inc.	NasdaqGS:EIGI	Internet Services and Infrastructure
Goosehead Insurance, Inc	NasdaqGS:GSHD	Insurance Brokers
Palomar Holdings, Inc.	NasdaqGS:PLMR	Property and Casualty Insurance
Berry Petroleum Corporation	NasdaqGS:BRY	Oil and Gas Exploration and Production
Stemline Therapeutics, Inc.	NasdaqCM:STML	Biotechnology
TPI Composites, Inc.	NasdaqGM:TPIC	Heavy Electrical Equipment
Puyi Inc.	NasdaqGM:PUYI	Asset Management and Custody Banks
Homology Medicines, Inc.	NasdaqGS:FIXX	Biotechnology
Allegiance Bancshares, Inc.	NasdaqGM:ABTX	Regional Banks
Forrester Research, Inc.	NasdaqGS:FORR	Research and Consulting Services
Quanterix Corporation	NasdaqGM:QTRX	Life Sciences Tools and Services
Gladstone Commercial Corporation	NasdaqGS:GOOD	Diversified REITs
DMC Global Inc.	NasdaqGS:BOOM	Oil and Gas Equipment and Services
Interface, Inc.	NasdaqGS:TILE	Office Services and Supplies
Great Lakes Dredge & Dock Corporation	NasdaqGS:GLDD	Construction and Engineering
Comtech Telecommunications Corp.	NasdaqGS:CMTL	Communications Equipment
Ingles Markets, Incorporated	NasdaqGS:IMKT.A	Food Retail
UroGen Pharma Ltd.	NasdaqGM:URGN	Biotechnology
Jiayin Group Inc.	NasdaqGM:JFIN	Consumer Finance
United Financial Bancorp, Inc.	NasdaqGS:UBNK	Thrifts and Mortgage Finance
CEVA, Inc.	NasdaqGS:CEVA	Semiconductors
Simulations Plus, Inc.	NasdaqCM:SLP	Health Care Technology
Astec Industries, Inc.	NasdaqGS:ASTE	Construction Machinery and Heavy Trucks
Barrett Business Services, Inc.	NasdaqGS:BBSI	Human Resource and Employment Services
HomeStreet, Inc.	NasdaqGS:HMST	Thrifts and Mortgage Finance
Houghton Mifflin Harcourt Company	NasdaqGS:HMHC	Education Services
Virtus Investment Partners, Inc.	NasdaqGS:VRTS	Asset Management and Custody Banks
Camden National Corporation	NasdaqGS:CAC	Regional Banks
Achillion Pharmaceuticals, Inc.	NasdaqGS:ACHN	Biotechnology
SMART Global Holdings, Inc.	NasdaqGS:SGH	Semiconductors
TechTarget, Inc.	NasdaqGM:TTGT	Advertising
Peoples Bancorp Inc.	NasdaqGS:PEBO	Regional Banks
Universal Electronics Inc.	NasdaqGS:UEIC	Consumer Electronics
Agilysys, Inc.	NasdaqGS:AGYS	Application Software
Sinovac Biotech Ltd.	NasdaqGS:SVA	Biotechnology
Harmonic Inc.	NasdaqGS:HLIT	Communications Equipment
Dorchester Minerals, L.P.	NasdaqGS:DMLP	Oil and Gas Exploration and Production
First Foundation Inc.	NasdaqGM:FFWM	Regional Banks
Winmark Corporation	NasdaqGM:WINA	Specialty Stores
LeMaitre Vascular, Inc.	NasdaqGM:LMAT	Health Care Equipment
Schnitzer Steel Industries, Inc.	NasdaqGS:SCHN	Steel
PaySign, Inc.	NasdaqCM:PAYS	Data Processing and Outsourced Services
Kimball International, Inc.	NasdaqGS:KBAL	Office Services and Supplies
GoPro, Inc.	NasdaqGS:GPRO	Consumer Electronics
Partner Communications Company Ltd.	NasdaqGS:PTNR	Wireless Telecommunication Services
Kiniksa Pharmaceuticals, Ltd.	NasdaqGS:KNSA	Biotechnology
HarborOne Bancorp, Inc.	NasdaqGS:HONE	Regional Banks
America's Car-Mart, Inc.	NasdaqGS:CRMT	Automotive Retail
Ruth's Hospitality Group, Inc.	NasdaqGS:RUTH	Restaurants
TG Therapeutics, Inc.	NasdaqCM:TGTX	Biotechnology
Viomi Technology Co., Ltd	NasdaqGS:VIOT	Household Appliances
Hanmi Financial Corporation	NasdaqGS:HAFC	Regional Banks
Conn's, Inc.	NasdaqGS:CONN	Computer and Electronics Retail
Heritage-Crystal Clean, Inc	NasdaqGS:HCCI	Environmental and Facilities Services
AVROBIO, Inc.	NasdaqGS:AVRO	Biotechnology
Niu Technologies	NasdaqGM:NIU	Motorcycle Manufacturers
Johnson Outdoors Inc.	NasdaqGS:JOUT	Leisure Products
Aegion Corporation	NasdaqGS:AEGN	Construction and Engineering
Photronics, Inc.	NasdaqGS:PLAB	Semiconductor Equipment
Ituran Location and Control Ltd.	NasdaqGS:ITRN	Communications Equipment
Rocket Pharmaceuticals, Inc.	NasdaqGM:RCKT	Biotechnology
Century Aluminum Company	NasdaqGS:CENX	Aluminum
QuinStreet, Inc.	NasdaqGS:QNST	Interactive Media and Services
Surmodics, Inc.	NasdaqGS:SRDX	Health Care Equipment
Zumiez Inc.	NasdaqGS:ZUMZ	Apparel Retail
Ribbon Communications Inc.	NasdaqGS:RBBN	Communications Equipment
Casa Systems, Inc.	NasdaqGS:CASA	Communications Equipment
Nicolet Bankshares, Inc.	NasdaqCM:NCBS	Regional Banks
Luther Burbank Corporation	NasdaqGS:LBC	Thrifts and Mortgage Finance
Heska Corporation	NasdaqCM:HSKA	Health Care Equipment
TriState Capital Holdings, Inc.	NasdaqGS:TSC	Regional Banks
Universal Logistics Holdings, Inc.	NasdaqGS:ULH	Trucking
QCR Holdings, Inc.	NasdaqGM:QCRH	Regional Banks
Napco Security Technologies, Inc.	NasdaqGS:NSSC	Electronic Equipment and Instruments
DXP Enterprises, Inc.	NasdaqGS:DXPE	Trading Companies and Distributors
eXp World Holdings, Inc.	NasdaqGM:EXPI	Real Estate Services
UP Fintech Holding Limited	NasdaqGS:TIGR	Investment Banking and Brokerage
Boingo Wireless, Inc.	NasdaqGS:WIFI	Wireless Telecommunication Services
Malibu Boats, Inc.	NasdaqGM:MBUU	Leisure Products
Bank of Marin Bancorp	NasdaqCM:BMRC	Regional Banks
Caesarstone Ltd.	NasdaqGS:CSTE	Building Products
Extraction Oil & Gas, Inc.	NasdaqGS:XOG	Oil and Gas Exploration and Production
Echo Global Logistics, Inc.	NasdaqGS:ECHO	Air Freight and Logistics
Carbonite, Inc.	NasdaqGM:CARB	Internet Services and Infrastructure
National CineMedia, Inc.	NasdaqGS:NCMI	Advertising
Revance Therapeutics, Inc.	NasdaqGM:RVNC	Pharmaceuticals
Endo International plc	NasdaqGS:ENDP	Pharmaceuticals
The First Bancshares, Inc.	NasdaqGM:FBMS	Regional Banks
B. Riley Financial, Inc.	NasdaqGM:RILY	Investment Banking and Brokerage
nLIGHT, Inc.	NasdaqGS:LASR	Electronic Equipment and Instruments
Karyopharm Therapeutics Inc.	NasdaqGS:KPTI	Biotechnology
Aurora Mobile Limited	NasdaqGM:JG	Application Software
Personalis, Inc.	NasdaqGM:PSNL	Life Sciences Tools and Services
Innophos Holdings, Inc.	NasdaqGS:IPHS	Specialty Chemicals
First Defiance Financial Corp.	NasdaqGS:FDEF	Thrifts and Mortgage Finance
NextCure, Inc.	NasdaqGS:NXTC	Biotechnology
People's Utah Bancorp	NasdaqCM:PUB	Regional Banks
Veeco Instruments Inc.	NasdaqGS:VECO	Semiconductor Equipment
The First of Long Island Corporation	NasdaqCM:FLIC	Regional Banks
Bridge Bancorp, Inc.	NasdaqGS:BDGE	Regional Banks
The Bancorp, Inc.	NasdaqGS:TBBK	Regional Banks
Flushing Financial Corporation	NasdaqGS:FFIC	Regional Banks
Digimarc Corporation	NasdaqGS:DMRC	Application Software
Cohu, Inc.	NasdaqGS:COHU	Semiconductor Equipment
Resources Connection, Inc.	NasdaqGS:RECN	Research and Consulting Services
AudioCodes Ltd.	NasdaqGS:AUDC	Communications Equipment
First Mid Bancshares, Inc.	NasdaqGM:FMBH	Regional Banks
Watford Holdings Ltd.	NasdaqGS:WTRE	Multi-line Insurance
Antares Pharma, Inc.	NasdaqCM:ATRS	Health Care Supplies
Energy Recovery, Inc.	NasdaqGS:ERII	Industrial Machinery
OneSpan Inc.	NasdaqCM:OSPN	Systems Software
ADTRAN, Inc.	NasdaqGS:ADTN	Communications Equipment
Pure Acquisition Corp.	NasdaqCM:PACQ	Asset Management and Custody Banks
Fossil Group, Inc.	NasdaqGS:FOSL	Apparel, Accessories and Luxury Goods
Digital Turbine, Inc.	NasdaqCM:APPS	Application Software
AxoGen, Inc.	NasdaqCM:AXGN	Health Care Equipment
Akebia Therapeutics, Inc.	NasdaqGM:AKBA	Biotechnology
Wanda Sports Group Company Limited	NasdaqGS:WSG	Movies and Entertainment
Heidrick & Struggles International, Inc.	NasdaqGS:HSII	Human Resource and Employment Services
Gulfport Energy Corporation	NasdaqGS:GPOR	Oil and Gas Exploration and Production
Mercantile Bank Corporation	NasdaqGS:MBWM	Regional Banks
Intersect ENT, Inc.	NasdaqGM:XENT	Pharmaceuticals
First Community Bankshares, Inc.	NasdaqGS:FCBC	Regional Banks
Catalyst Pharmaceuticals, Inc.	NasdaqCM:CPRX	Biotechnology
Karuna Therapeutics, Inc.	NasdaqGM:KRTX	Biotechnology
Peapack-Gladstone Financial Corporation	NasdaqGS:PGC	Regional Banks
Viking Therapeutics, Inc.	NasdaqCM:VKTX	Biotechnology
NextDecade Corporation	NasdaqCM:NEXT	Oil and Gas Storage and Transportation
EverQuote, Inc.	NasdaqGM:EVER	Interactive Media and Services
First Financial Corporation	NasdaqGS:THFF	Regional Banks
Autolus Therapeutics plc	NasdaqGS:AUTL	Biotechnology
Ultra Clean Holdings, Inc.	NasdaqGS:UCTT	Semiconductor Equipment
Intra-Cellular Therapies, Inc.	NasdaqGS:ITCI	Pharmaceuticals
Heritage Commerce Corp	NasdaqGS:HTBK	Regional Banks
United Insurance Holdings Corp.	NasdaqCM:UIHC	Property and Casualty Insurance
Gores Metropoulos, Inc.	NasdaqCM:GMHI	Asset Management and Custody Banks
Amalgamated Bank	NasdaqGM:AMAL	Regional Banks
Tucows Inc.	NasdaqCM:TCX	Internet Services and Infrastructure
Loop Industries, Inc.	NasdaqGM:LOOP	Commodity Chemicals
Gores Holdings III, Inc.	NasdaqCM:GRSH	Asset Management and Custody Banks
Carter Bank & Trust	NasdaqGS:CARE	Regional Banks
Merchants Bancorp	NasdaqCM:MBIN	Thrifts and Mortgage Finance
Renewable Energy Group, Inc.	NasdaqGS:REGI	Oil and Gas Refining and Marketing
Matrix Service Company	NasdaqGS:MTRX	Oil and Gas Equipment and Services
Green Brick Partners, Inc.	NasdaqCM:GRBK	Homebuilding
Plug Power Inc.	NasdaqCM:PLUG	Electrical Components and Equipment
Cowen Inc.	NasdaqGS:COWN	Investment Banking and Brokerage
Aptorum Group Limited	NasdaqGM:APM	Biotechnology
Blue Bird Corporation	NasdaqGM:BLBD	Construction Machinery and Heavy Trucks
Evolus, Inc.	NasdaqGM:EOLS	Pharmaceuticals
Ichor Holdings, Ltd.	NasdaqGS:ICHR	Semiconductor Equipment
Axcelis Technologies, Inc.	NasdaqGS:ACLS	Semiconductor Equipment
The York Water Company	NasdaqGS:YORW	Water Utilities
FRP Holdings, Inc.	NasdaqGS:FRPH	Real Estate Operating Companies
Fluidigm Corporation	NasdaqGS:FLDM	Life Sciences Tools and Services
The Hackett Group, Inc.	NasdaqGS:HCKT	IT Consulting and Other Services
MidWestOne Financial Group, Inc.	NasdaqGS:MOFG	Regional Banks
Gilat Satellite Networks Ltd.	NasdaqGS:GILT	Communications Equipment
EZCORP, Inc.	NasdaqGS:EZPW	Consumer Finance
Cutera, Inc.	NasdaqGS:CUTR	Health Care Equipment
Penn Virginia Corporation	NasdaqGS:PVAC	Oil and Gas Exploration and Production
Hemisphere Media Group, Inc.	NasdaqGM:HMTV	Broadcasting
Synthorx, Inc.	NasdaqGS:THOR	Biotechnology
Arrow Financial Corporation	NasdaqGS:AROW	Regional Banks
MYR Group Inc.	NasdaqGS:MYRG	Construction and Engineering
United Community Financial Corp.	NasdaqGS:UCFC	Thrifts and Mortgage Finance
Magenta Therapeutics, Inc.	NasdaqGM:MGTA	Biotechnology
Clean Energy Fuels Corp.	NasdaqGS:CLNE	Oil and Gas Refining and Marketing
Meridian Bioscience, Inc.	NasdaqGS:VIVO	Health Care Supplies
SI-BONE, Inc.	NasdaqGM:SIBN	Health Care Supplies
Establishment Labs Holdings Inc.	NasdaqCM:ESTA	Health Care Supplies
Hawkins, Inc.	NasdaqGS:HWKN	Commodity Chemicals
Sterling Bancorp, Inc. (Southfield, MI)	NasdaqCM:SBT	Thrifts and Mortgage Finance
Telenav, Inc.	NasdaqGS:TNAV	Application Software
OrthoPediatrics Corp.	NasdaqGM:KIDS	Health Care Supplies
RISE Education Cayman Ltd	NasdaqGM:REDU	Education Services
Brightcove Inc.	NasdaqGS:BCOV	Internet Services and Infrastructure
OraSure Technologies, Inc.	NasdaqGS:OSUR	Health Care Supplies
Financial Institutions, Inc.	NasdaqGS:FISI	Regional Banks
United States Lime & Minerals, Inc.	NasdaqGS:USLM	Construction Materials
Precision BioSciences, Inc.	NasdaqGS:DTIL	Biotechnology
Boston Omaha Corporation	NasdaqCM:BOMN	Advertising
Dova Pharmaceuticals, Inc.	NasdaqGM:DOVA	Pharmaceuticals
CytomX Therapeutics, Inc.	NasdaqGS:CTMX	Biotechnology
Primo Water Corporation	NasdaqGM:PRMW	Soft Drinks
Crinetics Pharmaceuticals, Inc.	NasdaqGS:CRNX	Biotechnology
Old Line Bancshares, Inc.	NasdaqCM:OLBK	Regional Banks
Century Bancorp, Inc.	NasdaqGS:CNBK.A	Regional Banks
Dermira, Inc.	NasdaqGS:DERM	Pharmaceuticals
American Outdoor Brands Corporation	NasdaqGS:AOBC	Leisure Products
GreenSky, Inc.	NasdaqGS:GSKY	Data Processing and Outsourced Services
HomeTrust Bancshares, Inc.	NasdaqGS:HTBI	Regional Banks
InMode Ltd.	NasdaqGS:INMD	Health Care Equipment
Independent Bank Corporation	NasdaqGS:IBCP	Regional Banks
Trinity Merger Corp.	NasdaqCM:TMCX	Asset Management and Custody Banks
Forterra, Inc.	NasdaqGS:FRTA	Construction Materials
Diamond Hill Investment Group, Inc.	NasdaqGS:DHIL	Asset Management and Custody Banks
Sentinel Energy Services Inc.	NasdaqCM:STNL	Asset Management and Custody Banks
FinTech Acquisition Corp. III	NasdaqCM:FTAC	Asset Management and Custody Banks
Spartan Motors, Inc.	NasdaqGS:SPAR	Construction Machinery and Heavy Trucks
BeyondSpring Inc.	NasdaqCM:BYSI	Biotechnology
Chuy's Holdings, Inc.	NasdaqGS:CHUY	Restaurants
Powell Industries, Inc.	NasdaqGS:POWL	Electrical Components and Equipment
Red Robin Gourmet Burgers, Inc.	NasdaqGS:RRGB	Restaurants
Zix Corporation	NasdaqGS:ZIXI	Application Software
Puma Biotechnology, Inc.	NasdaqGS:PBYI	Biotechnology
TransMedics Group, Inc.	NasdaqGM:TMDX	Health Care Equipment
Stealth BioTherapeutics Corp	NasdaqGM:MITO	Biotechnology
Waterstone Financial, Inc.	NasdaqGS:WSBF	Thrifts and Mortgage Finance
America First Multifamily Investors, L.P.	NasdaqGS:ATAX	Thrifts and Mortgage Finance
Magic Software Enterprises Ltd.	NasdaqGS:MGIC	Application Software
ImmunoGen, Inc.	NasdaqGS:IMGN	Biotechnology
PCM, Inc.	NasdaqGM:PCMI	Technology Distributors
USA Technologies, Inc.	NasdaqGM:USAT	Data Processing and Outsourced Services
Flexion Therapeutics, Inc.	NasdaqGM:FLXN	Biotechnology
Kodiak Sciences Inc.	NasdaqGM:KOD	Biotechnology
ObsEva SA	NasdaqGS:OBSV	Biotechnology
American Software, Inc.	NasdaqGS:AMSW.A	Application Software
Titan Machinery Inc.	NasdaqGS:TITN	Trading Companies and Distributors
Del Taco Restaurants, Inc.	NasdaqCM:TACO	Restaurants
American Public Education, Inc.	NasdaqGS:APEI	Education Services
Translate Bio, Inc.	NasdaqGS:TBIO	Biotechnology
BioSpecifics Technologies Corp.	NasdaqGM:BSTC	Biotechnology
Capital City Bank Group, Inc.	NasdaqGS:CCBG	Regional Banks
ORBCOMM Inc.	NasdaqGS:ORBC	Alternative Carriers
Donegal Group Inc.	NasdaqGS:DGIC.B	Property and Casualty Insurance
SIGA Technologies, Inc.	NasdaqGM:SIGA	Pharmaceuticals
Landmark Infrastructure Partners LP	NasdaqGM:LMRK	Real Estate Operating Companies
Gogo Inc.	NasdaqGS:GOGO	Wireless Telecommunication Services
CNB Financial Corporation	NasdaqGS:CCNE	Regional Banks
Himax Technologies, Inc.	NasdaqGS:HIMX	Semiconductors
Atlantic Capital Bancshares, Inc.	NasdaqGS:ACBI	Regional Banks
Vera Bradley, Inc.	NasdaqGS:VRA	Apparel, Accessories and Luxury Goods
IES Holdings, Inc.	NasdaqGM:IESC	Construction and Engineering
Progenics Pharmaceuticals, Inc.	NasdaqGS:PGNX	Biotechnology
CymaBay Therapeutics, Inc.	NasdaqGS:CBAY	Pharmaceuticals
Hingham Institution for Savings	NasdaqGM:HIFS	Thrifts and Mortgage Finance
Newtek Business Services Corp.	NasdaqGM:NEWT	Asset Management and Custody Banks
ChemoCentryx, Inc.	NasdaqGS:CCXI	Biotechnology
Equity Bancshares, Inc.	NasdaqGS:EQBK	Regional Banks
Avedro, Inc.	NasdaqGM:AVDR	Health Care Equipment
El Pollo Loco Holdings, Inc.	NasdaqGS:LOCO	Restaurants
Farmers National Banc Corp.	NasdaqCM:FMNB	Regional Banks
Capital Southwest Corporation	NasdaqGS:CSWC	Asset Management and Custody Banks
Milestone Pharmaceuticals Inc.	NasdaqGS:MIST	Pharmaceuticals
Diamond Eagle Acquisition Corp.	NasdaqCM:DEAC	Asset Management and Custody Banks
Organogenesis Holdings Inc.	NasdaqCM:ORGO	Biotechnology
BioDelivery Sciences International, Inc.	NasdaqCM:BDSI	Pharmaceuticals
American National Bankshares Inc.	NasdaqGS:AMNB	Regional Banks
Golden Entertainment, Inc.	NasdaqGM:GDEN	Casinos and Gaming
Mitek Systems, Inc.	NasdaqCM:MITK	Application Software
Merus N.V.	NasdaqGM:MRUS	Biotechnology
Repay Holdings Corporation	NasdaqCM:RPAY	Data Processing and Outsourced Services
Landcadia Holdings II, Inc.	NasdaqCM:LCA	Asset Management and Custody Banks
PDF Solutions, Inc.	NasdaqGS:PDFS	Semiconductor Equipment
Sierra Bancorp	NasdaqGS:BSRR	Regional Banks
Corbus Pharmaceuticals Holdings, Inc.	NasdaqGM:CRBP	Biotechnology
Willdan Group, Inc.	NasdaqGM:WLDN	Research and Consulting Services
Tuniu Corporation	NasdaqGM:TOUR	Hotels, Resorts and Cruise Lines
GenMark Diagnostics, Inc.	NasdaqGM:GNMK	Health Care Equipment
Akorn, Inc.	NasdaqGS:AKRX	Pharmaceuticals
Provention Bio, Inc.	NasdaqCM:PRVB	Pharmaceuticals
BioScrip, Inc.	NasdaqGS:BIOS	Health Care Services
Collegium Pharmaceutical, Inc.	NasdaqGS:COLL	Pharmaceuticals
AC Immune SA	NasdaqGM:ACIU	Biotechnology
Acamar Partners Acquisition Corp.	NasdaqCM:ACAM	Asset Management and Custody Banks
Oxford Immunotec Global PLC	NasdaqGM:OXFD	Health Care Equipment
Hennessy Capital Acquisition Corp. IV	NasdaqCM:HCAC	Asset Management and Custody Banks
TrueCar, Inc.	NasdaqGS:TRUE	Interactive Media and Services
MediciNova, Inc.	NasdaqGM:MNOV	Biotechnology
Secoo Holding Limited	NasdaqGM:SECO	Internet and Direct Marketing Retail
Syros Pharmaceuticals, Inc.	NasdaqGS:SYRS	Biotechnology
NI Holdings, Inc.	NasdaqCM:NODK	Property and Casualty Insurance
Kimball Electronics, Inc.	NasdaqGS:KE	Electronic Manufacturing Services
Amyris, Inc.	NasdaqGS:AMRS	Specialty Chemicals
Pioneer Bancorp, Inc.	NasdaqCM:PBFS	Thrifts and Mortgage Finance
Act II Global Acquisition Corp.	NasdaqCM:ACTT	Asset Management and Custody Banks
Digi International Inc.	NasdaqGS:DGII	Communications Equipment
Bank First Corporation	NasdaqCM:BFC	Regional Banks
Carrols Restaurant Group, Inc.	NasdaqGS:TAST	Restaurants
Cross Country Healthcare, Inc.	NasdaqGS:CCRN	Health Care Services
RBB Bancorp	NasdaqGS:RBB	Regional Banks
TCR2 Therapeutics Inc.	NasdaqGS:TCRR	Biotechnology
Lawson Products, Inc.	NasdaqGS:LAWS	Trading Companies and Distributors
Old Second Bancorp, Inc.	NasdaqGS:OSBC	Regional Banks
Avid Bioservices, Inc.	NasdaqCM:CDMO	Biotechnology
AGM Group Holdings Inc.	NasdaqCM:AGMH	Financial Exchanges and Data
Haynes International, Inc.	NasdaqGS:HAYN	Steel
Southern National Bancorp of Virginia, Inc.	NasdaqGM:SONA	Regional Banks
SpartanNash Company	NasdaqGS:SPTN	Food Distributors
Synchronoss Technologies, Inc.	NasdaqGS:SNCR	Application Software
TuanChe Limited	NasdaqCM:TC	Advertising
Assembly Biosciences, Inc.	NasdaqGS:ASMB	Biotechnology
CF Finance Acquisition Corp.	NasdaqCM:CFFA	Asset Management and Custody Banks
Duluth Holdings Inc.	NasdaqGS:DLTH	Internet and Direct Marketing Retail
Utah Medical Products, Inc.	NasdaqGS:UTMD	Health Care Supplies
ShotSpotter, Inc.	NasdaqCM:SSTI	Application Software
Rigel Pharmaceuticals, Inc.	NasdaqGS:RIGL	Biotechnology
Castle Biosciences, Inc.	NasdaqGM:CSTL	Biotechnology
Gritstone Oncology, Inc.	NasdaqGS:GRTS	Biotechnology
Village Super Market, Inc.	NasdaqGS:VLGE.A	Food Retail
Cambridge Bancorp	NasdaqCM:CATC	Regional Banks
Alphatec Holdings, Inc.	NasdaqGS:ATEC	Health Care Equipment
Insteel Industries, Inc.	NasdaqGS:IIIN	Building Products
AMAG Pharmaceuticals, Inc.	NasdaqGS:AMAG	Biotechnology
Greenlight Capital Re, Ltd.	NasdaqGS:GLRE	Reinsurance
Nebula Acquisition Corporation	NasdaqCM:NEBU	Asset Management and Custody Banks
Willis Lease Finance Corporation	NasdaqGM:WLFC	Trading Companies and Distributors
CalAmp Corp.	NasdaqGS:CAMP	Communications Equipment
Shoe Carnival, Inc.	NasdaqGS:SCVL	Apparel Retail
Guaranty Bancshares, Inc.	NasdaqGS:GNTY	Regional Banks
Calumet Specialty Products Partners, L.P.	NasdaqGS:CLMT	Oil and Gas Refining and Marketing
Yintech Investment Holdings Limited	NasdaqGS:YIN	Investment Banking and Brokerage
Agenus Inc.	NasdaqCM:AGEN	Biotechnology
Atreca, Inc.	NasdaqGS:BCEL	Biotechnology
Consolidated Communications Holdings, Inc.	NasdaqGS:CNSL	Integrated Telecommunication Services
West Bancorporation, Inc.	NasdaqGS:WTBA	Regional Banks
Prothena Corporation plc	NasdaqGS:PRTA	Biotechnology
Macatawa Bank Corporation	NasdaqGS:MCBC	Regional Banks
i3 Verticals, Inc.	NasdaqGS:IIIV	Data Processing and Outsourced Services
Home Bancorp, Inc.	NasdaqGS:HBCP	Thrifts and Mortgage Finance
resTORbio, Inc.	NasdaqGS:TORC	Pharmaceuticals
DiamondPeak Holdings Corp.	NasdaqCM:DPHC	Asset Management and Custody Banks
Inseego Corp.	NasdaqGS:INSG	Communications Equipment
Majesco	NasdaqGM:MJCO	Application Software
Spirit of Texas Bancshares, Inc.	NasdaqGS:STXB	Regional Banks
BioLife Solutions, Inc.	NasdaqCM:BLFS	Health Care Supplies
Replimune Group, Inc.	NasdaqGS:REPL	Biotechnology
Park-Ohio Holdings Corp.	NasdaqGS:PKOH	Industrial Machinery
Limoneira Company	NasdaqGS:LMNR	Agricultural Products
Red River Bancshares, Inc.	NasdaqGS:RRBI	Regional Banks
Cadiz Inc.	NasdaqGM:CDZI	Water Utilities
Civista Bancshares, Inc.	NasdaqCM:CIVB	Regional Banks
Allied Motion Technologies Inc.	NasdaqGM:AMOT	Electrical Components and Equipment
Forty Seven, Inc.	NasdaqGS:FTSV	Biotechnology
Mirum Pharmaceuticals, Inc.	NasdaqGM:MIRM	Biotechnology
ProQR Therapeutics N.V.	NasdaqGM:PRQR	Biotechnology
Camtek Ltd.	NasdaqGM:CAMT	Semiconductor Equipment
Citizens & Northern Corporation	NasdaqCM:CZNC	Regional Banks
Pareteum Corporation	NasdaqCM:TEUM	Integrated Telecommunication Services
Clarus Corporation	NasdaqGS:CLAR	Leisure Products
Prevail Therapeutics Inc.	NasdaqGM:PRVL	Biotechnology
Bridgewater Bancshares, Inc.	NasdaqCM:BWB	Thrifts and Mortgage Finance
Peoples Financial Services Corp.	NasdaqGS:PFIS	Regional Banks
Landec Corporation	NasdaqGS:LNDC	Packaged Foods and Meats
Tecnoglass Inc.	NasdaqCM:TGLS	Construction Materials
Enterprise Bancorp, Inc.	NasdaqGS:EBTC	Regional Banks
DryShips Inc.	NasdaqCM:DRYS	Marine
CRA International, Inc.	NasdaqGS:CRAI	Research and Consulting Services
Artesian Resources Corporation	NasdaqGS:ARTN.A	Water Utilities
VSE Corporation	NasdaqGS:VSEC	Diversified Support Services
Isramco, Inc.	NasdaqCM:ISRL	Oil and Gas Exploration and Production
Rimini Street, Inc.	NasdaqGM:RMNI	Application Software
DSP Group, Inc.	NasdaqGS:DSPG	Semiconductors
Bridgford Foods Corporation	NasdaqGM:BRID	Packaged Foods and Meats
Empire Resorts, Inc.	NasdaqGM:NYNY	Casinos and Gaming
Green Plains Inc.	NasdaqGS:GPRE	Oil and Gas Refining and Marketing
Computer Programs and Systems, Inc.	NasdaqGS:CPSI	Health Care Technology
Surgery Partners, Inc.	NasdaqGS:SGRY	Health Care Facilities
DFB Healthcare Acquisitions Corp.	NasdaqCM:DFBH	Asset Management and Custody Banks
Legacy Housing Corporation	NasdaqGS:LEGH	Homebuilding
Changyou.com Limited	NasdaqGS:CYOU	Interactive Home Entertainment
PCSB Financial Corporation	NasdaqCM:PCSB	Thrifts and Mortgage Finance
Summit Financial Group, Inc.	NasdaqCM:SMMF	Regional Banks
NVE Corporation	NasdaqCM:NVEC	Semiconductors
Scholar Rock Holding Corporation	NasdaqGS:SRRK	Biotechnology
PetMed Express, Inc.	NasdaqGS:PETS	Internet and Direct Marketing Retail
Sientra, Inc.	NasdaqGS:SIEN	Health Care Supplies
GTY Technology Holdings Inc.	NasdaqCM:GTYH	Application Software
Accuray Incorporated	NasdaqGS:ARAY	Health Care Equipment
BioCryst Pharmaceuticals, Inc.	NasdaqGS:BCRX	Biotechnology
Lands' End, Inc.	NasdaqCM:LE	Internet and Direct Marketing Retail
PDL BioPharma, Inc.	NasdaqGS:PDLI	Biotechnology
Clovis Oncology, Inc.	NasdaqGS:CLVS	Biotechnology
Green Plains Partners LP	NasdaqGM:GPP	Oil and Gas Storage and Transportation
UFP Technologies, Inc.	NasdaqCM:UFPT	Paper Packaging
Harpoon Therapeutics, Inc.	NasdaqGS:HARP	Biotechnology
Southern Missouri Bancorp, Inc.	NasdaqGM:SMBC	Thrifts and Mortgage Finance
Crescent Acquisition Corp.	NasdaqCM:CRSA	Asset Management and Custody Banks
ViewRay, Inc.	NasdaqGM:VRAY	Health Care Equipment
Business First Bancshares, Inc.	NasdaqGS:BFST	Regional Banks
Daily Journal Corporation	NasdaqCM:DJCO	Publishing
South Plains Financial, Inc.	NasdaqGS:SPFI	Regional Banks
Altisource Portfolio Solutions S.A.	NasdaqGS:ASPS	Real Estate Services
NuCana plc	NasdaqGS:NCNA	Biotechnology
VectoIQ Acquisition Corp.	NasdaqCM:VTIQ	Asset Management and Custody Banks
Pope Resources, A Delaware Limited Partnership	NasdaqCM:POPE	Forest Products
Unity Biotechnology, Inc.	NasdaqGS:UBX	Biotechnology
Motorcar Parts of America, Inc.	NasdaqGS:MPAA	Auto Parts and Equipment
Nathan's Famous, Inc.	NasdaqGS:NATH	Restaurants
Adesto Technologies Corporation	NasdaqCM:IOTS	Semiconductors
P.A.M. Transportation Services, Inc.	NasdaqGM:PTSI	Trucking
Fiesta Restaurant Group, Inc.	NasdaqGS:FRGI	Restaurants
Investors Title Company	NasdaqGS:ITIC	Property and Casualty Insurance
Sterling Construction Company, Inc.	NasdaqGS:STRL	Construction and Engineering
Ruhnn Holding Limited	NasdaqGS:RUHN	Internet and Direct Marketing Retail
XBiotech Inc.	NasdaqGS:XBIT	Biotechnology
Reading International, Inc.	NasdaqCM:RDI	Movies and Entertainment
SmartFinancial, Inc.	NasdaqCM:SMBK	Regional Banks
Xeris Pharmaceuticals, Inc.	NasdaqGS:XERS	Pharmaceuticals
Southern First Bancshares, Inc.	NasdaqGM:SFST	Regional Banks
CASI Pharmaceuticals, Inc.	NasdaqCM:CASI	Biotechnology
Noodles & Company	NasdaqGS:NDLS	Restaurants
Hibbett Sports, Inc.	NasdaqGS:HIBB	Specialty Stores
NN, Inc.	NasdaqGS:NNBR	Industrial Machinery
Craft Brew Alliance, Inc.	NasdaqGS:BREW	Brewers
Hydrogenics Corporation	NasdaqGM:HYGS	Electrical Components and Equipment
Dynavax Technologies Corporation	NasdaqCM:DVAX	Biotechnology
New Age Beverages Corporation	NasdaqCM:NBEV	Soft Drinks
Marlin Business Services Corp.	NasdaqGS:MRLN	Specialized Finance
Limelight Networks, Inc.	NasdaqGS:LLNW	Internet Services and Infrastructure
Avid Technology, Inc.	NasdaqGS:AVID	Technology Hardware, Storage and Peripherals
Kindred Biosciences, Inc.	NasdaqCM:KIN	Biotechnology
Howard Bancorp, Inc.	NasdaqCM:HBMD	Regional Banks
Hallmark Financial Services, Inc.	NasdaqGM:HALL	Property and Casualty Insurance
Tribune Publishing Company	NasdaqGM:TPCO	Publishing
Farmers & Merchants Bancorp, Inc.	NasdaqCM:FMAO	Regional Banks
Siebert Financial Corp.	NasdaqCM:SIEB	Investment Banking and Brokerage
ACM Research, Inc.	NasdaqGM:ACMR	Semiconductor Equipment
DURECT Corporation	NasdaqCM:DRRX	Pharmaceuticals
Select Interior Concepts, Inc.	NasdaqCM:SIC	Specialized Consumer Services
Covenant Transportation Group, Inc.	NasdaqGS:CVTI	Trucking
Alpha and Omega Semiconductor Limited	NasdaqGS:AOSL	Semiconductors
MutualFirst Financial, Inc.	NasdaqGM:MFSF	Regional Banks
Twelve Seas Investment Company	NasdaqCM:BROG	Asset Management and Custody Banks
The First Bancorp, Inc.	NasdaqGS:FNLC	Regional Banks
Central Valley Community Bancorp	NasdaqCM:CVCY	Regional Banks
MasterCraft Boat Holdings, Inc.	NasdaqGM:MCFT	Leisure Products
CECO Environmental Corp.	NasdaqGS:CECE	Environmental and Facilities Services
Zynex, Inc.	NasdaqCM:ZYXI	Health Care Equipment
Capstar Financial Holdings, Inc.	NasdaqGS:CSTR	Regional Banks
KalVista Pharmaceuticals, Inc.	NasdaqGM:KALV	Biotechnology
The Lovesac Company	NasdaqGM:LOVE	Home Furnishings
Syndax Pharmaceuticals, Inc.	NasdaqGS:SNDX	Biotechnology
KLX Energy Services Holdings, Inc.	NasdaqGS:KLXE	Oil and Gas Equipment and Services
Daktronics, Inc.	NasdaqGS:DAKT	Electronic Equipment and Instruments
Minerva Neurosciences, Inc.	NasdaqGM:NERV	Biotechnology
Mudrick Capital Acquisition Corporation	NasdaqCM:MUDS	Asset Management and Custody Banks
Del Frisco's Restaurant Group, Inc.	NasdaqGS:DFRG	Restaurants
111, Inc.	NasdaqGM:YI	Drug Retail
Sorrento Therapeutics, Inc.	NasdaqCM:SRNE	Biotechnology
Reliant Bancorp, Inc.	NasdaqCM:RBNC	Regional Banks
Kandi Technologies Group, Inc.	NasdaqGS:KNDI	Auto Parts and Equipment
Health Insurance Innovations, Inc.	NasdaqGM:HIIQ	Insurance Brokers
Eloxx Pharmaceuticals, Inc.	NasdaqGM:ELOX	Pharmaceuticals
Kaleido BioSciences, Inc.	NasdaqGS:KLDO	Pharmaceuticals
Enlivex Therapeutics Ltd.	NasdaqCM:ENLV	Biotechnology
BayCom Corp	NasdaqGS:BCML	Regional Banks
Celsius Holdings, Inc.	NasdaqCM:CELH	Soft Drinks
Geron Corporation	NasdaqGS:GERN	Biotechnology
The Meet Group, Inc.	NasdaqCM:MEET	Interactive Media and Services
PCB Bancorp	NasdaqGS:PCB	Regional Banks
Territorial Bancorp Inc.	NasdaqGS:TBNK	Thrifts and Mortgage Finance
Catasys, Inc.	NasdaqCM:CATS	Health Care Services
ACNB Corporation	NasdaqCM:ACNB	Regional Banks
Pieris Pharmaceuticals, Inc.	NasdaqCM:PIRS	Biotechnology
Zynerba Pharmaceuticals, Inc.	NasdaqGM:ZYNE	Pharmaceuticals
Global Water Resources, Inc.	NasdaqGM:GWRS	Water Utilities
Pure Cycle Corporation	NasdaqCM:PCYO	Water Utilities
New Fortress Energy LLC	NasdaqGS:NFE	Oil and Gas Refining and Marketing
Verrica Pharmaceuticals Inc.	NasdaqGM:VRCA	Pharmaceuticals
The Joint Corp.	NasdaqCM:JYNT	Health Care Facilities
Allot Ltd.	NasdaqGS:ALLT	Systems Software
Provident Bancorp, Inc.	NasdaqCM:PVBC	Thrifts and Mortgage Finance
Preformed Line Products Company	NasdaqGS:PLPC	Electrical Components and Equipment
Boxwood Merger Corp.	NasdaqCM:BWMC	Asset Management and Custody Banks
Eiger BioPharmaceuticals, Inc.	NasdaqGM:EIGR	Biotechnology
Immersion Corporation	NasdaqGS:IMMR	Technology Hardware, Storage and Peripherals
Century Casinos, Inc.	NasdaqCM:CNTY	Casinos and Gaming
Apyx Medical Corporation	NasdaqGS:APYX	Health Care Equipment
First Choice Bancorp	NasdaqCM:FCBP	Regional Banks
Value Line, Inc.	NasdaqCM:VALU	Financial Exchanges and Data
Protagonist Therapeutics, Inc.	NasdaqGM:PTGX	Biotechnology
Cumulus Media Inc.	NasdaqGM:CMLS	Broadcasting
Farmer Bros. Co.	NasdaqGS:FARM	Packaged Foods and Meats
Inovio Pharmaceuticals, Inc.	NasdaqGS:INO	Biotechnology
Recro Pharma, Inc.	NasdaqCM:REPH	Biotechnology
Concert Pharmaceuticals, Inc.	NasdaqGM:CNCE	Biotechnology
Northwest Pipe Company	NasdaqGS:NWPX	Construction and Engineering
IRadimed Corporation	NasdaqCM:IRMD	Health Care Equipment
Gladstone Land Corporation	NasdaqGM:LAND	Specialized REITs
RTI Surgical Holdings, Inc.	NasdaqGS:RTIX	Health Care Supplies
Urovant Sciences Ltd.	NasdaqGS:UROV	Pharmaceuticals
Ponce Bank	NasdaqGM:PDLB	Thrifts and Mortgage Finance
Cyclerion Therapeutics, Inc.	NasdaqGS:CYCN	Biotechnology
Weyco Group, Inc.	NasdaqGS:WEYS	Distributors
ChromaDex Corporation	NasdaqCM:CDXC	Life Sciences Tools and Services
Ames National Corporation	NasdaqCM:ATLO	Regional Banks
FVCBankcorp, Inc.	NasdaqCM:FVCB	Regional Banks
L.B. Foster Company	NasdaqGS:FSTR	Industrial Machinery
Calyxt, Inc.	NasdaqGM:CLXT	Biotechnology
Republic First Bancorp, Inc.	NasdaqGM:FRBK	Regional Banks
Xenon Pharmaceuticals Inc.	NasdaqGM:XENE	Biotechnology
SciPlay Corporation	NasdaqGS:SCPL	Interactive Home Entertainment
Northrim BanCorp, Inc.	NasdaqGS:NRIM	Regional Banks
La Jolla Pharmaceutical Company	NasdaqCM:LJPC	Biotechnology
Protective Insurance Corporation	NasdaqGM:PTVC.B	Property and Casualty Insurance
Seneca Foods Corporation	NasdaqGS:SENE.A	Packaged Foods and Meats
Wins Finance Holdings Inc.	NasdaqCM:WINS	Asset Management and Custody Banks
Cellular Biomedicine Group, Inc.	NasdaqGS:CBMG	Biotechnology
Fidelity D & D Bancorp, Inc.	NasdaqGM:FDBC	Regional Banks
PrimeEnergy Resources Corporation	NasdaqCM:PNRG	Oil and Gas Exploration and Production
Orrstown Financial Services, Inc.	NasdaqCM:ORRF	Regional Banks
Fluent, Inc.	NasdaqGM:FLNT	Advertising
MBT Financial Corp.	NasdaqGS:MBTF	Regional Banks
InnerWorkings, Inc.	NasdaqGS:INWK	Research and Consulting Services
Parke Bancorp, Inc.	NasdaqCM:PKBK	Regional Banks
Smith Micro Software, Inc.	NasdaqCM:SMSI	Application Software
Sutro Biopharma, Inc.	NasdaqGM:STRO	Biotechnology
Alico, Inc.	NasdaqGS:ALCO	Agricultural Products
Commercial Vehicle Group, Inc.	NasdaqGS:CVGI	Construction Machinery and Heavy Trucks
Greene County Bancorp, Inc.	NasdaqCM:GCBC	Thrifts and Mortgage Finance
National Bankshares, Inc.	NasdaqCM:NKSH	Regional Banks
Liquidity Services, Inc.	NasdaqGS:LQDT	Internet and Direct Marketing Retail
Cambium Networks Corporation	NasdaqGM:CMBM	Communications Equipment
Silicom Ltd.	NasdaqGS:SILC	Communications Equipment
PhaseBio Pharmaceuticals, Inc.	NasdaqGM:PHAS	Biotechnology
Investar Holding Corporation	NasdaqGM:ISTR	Regional Banks
Ceragon Networks Ltd.	NasdaqGS:CRNT	Communications Equipment
SeaSpine Holdings Corporation	NasdaqGS:SPNE	Health Care Equipment
Aeglea BioTherapeutics, Inc.	NasdaqGM:AGLE	Biotechnology
Tiptree Inc.	NasdaqCM:TIPT	Property and Casualty Insurance
Ferroglobe PLC	NasdaqGS:GSM	Diversified Metals and Mining
iClick Interactive Asia Group Limited	NasdaqGM:ICLK	Advertising
Spok Holdings, Inc.	NasdaqGS:SPOK	Wireless Telecommunication Services
General Finance Corporation	NasdaqGM:GFN	Trading Companies and Distributors
Premier Financial Bancorp, Inc.	NasdaqGM:PFBI	Regional Banks
Workhorse Group Inc.	NasdaqCM:WKHS	Auto Parts and Equipment
Pulse Biosciences, Inc.	NasdaqCM:PLSE	Health Care Equipment
Western New England Bancorp, Inc.	NasdaqGS:WNEB	Thrifts and Mortgage Finance
Hooker Furniture Corporation	NasdaqGS:HOFT	Home Furnishings
LogicBio Therapeutics, Inc.	NasdaqGM:LOGC	Biotechnology
China Index Holdings Limited	NasdaqGS:CIH	Research and Consulting Services
LCNB Corp.	NasdaqCM:LCNB	Regional Banks
Constellation Pharmaceuticals, Inc.	NasdaqGS:CNST	Biotechnology
Compugen Ltd.	NasdaqGM:CGEN	Life Sciences Tools and Services
RGC Resources, Inc.	NasdaqGM:RGCO	Gas Utilities
eGain Corporation	NasdaqCM:EGAN	Application Software
Unity Bancorp, Inc.	NasdaqGM:UNTY	Regional Banks
Superior Group of Companies, Inc.	NasdaqGM:SGC	Apparel, Accessories and Luxury Goods
Hurco Companies, Inc.	NasdaqGS:HURC	Industrial Machinery
Advanced Emissions Solutions, Inc.	NasdaqGM:ADES	Specialty Chemicals
Rocky Brands, Inc.	NasdaqGS:RCKY	Footwear
OptiNose, Inc.	NasdaqGS:OPTN	Pharmaceuticals
Misonix, Inc.	NasdaqGM:MSON	Health Care Equipment
SB One Bancorp	NasdaqGM:SBBX	Regional Banks
Consolidated Water Co. Ltd.	NasdaqGS:CWCO	Water Utilities
Stratus Properties Inc.	NasdaqGS:STRS	Real Estate Development
Marker Therapeutics, Inc.	NasdaqCM:MRKR	Biotechnology
Chiasma, Inc.	NasdaqGS:CHMA	Pharmaceuticals
Applied Optoelectronics, Inc.	NasdaqGM:AAOI	Communications Equipment
Gravity Co., Ltd.	NasdaqGM:GRVY	Interactive Home Entertainment
FS Bancorp, Inc.	NasdaqCM:FSBW	Thrifts and Mortgage Finance
Iteris, Inc.	NasdaqCM:ITI	Electronic Equipment and Instruments
Ideanomics, Inc.	NasdaqCM:IDEX	Application Software
Select Bancorp, Inc.	NasdaqGM:SLCT	Regional Banks
Tuscan Holdings Corp. II	NasdaqCM:THCA	Asset Management and Custody Banks
Collectors Universe, Inc.	NasdaqGM:CLCT	Specialized Consumer Services
Altus Midstream Company	NasdaqGM:ALTM	Oil and Gas Storage and Transportation
Solid Biosciences Inc.	NasdaqGS:SLDB	Biotechnology
Fulgent Genetics, Inc.	NasdaqGM:FLGT	Health Care Services
ADMA Biologics, Inc.	NasdaqCM:ADMA	Biotechnology
Entegra Financial Corp.	NasdaqGM:ENFC	Thrifts and Mortgage Finance
Timberland Bancorp, Inc.	NasdaqGM:TSBK	Thrifts and Mortgage Finance
Insurance Acquisition Corp.	NasdaqCM:INSU	Asset Management and Custody Banks
Celcuity Inc.	NasdaqCM:CELC	Biotechnology
Ocular Therapeutix, Inc.	NasdaqGM:OCUL	Pharmaceuticals
DASAN Zhone Solutions, Inc.	NasdaqCM:DZSI	Communications Equipment
MannKind Corporation	NasdaqGM:MNKD	Biotechnology
Adaptimmune Therapeutics plc	NasdaqGS:ADAP	Biotechnology
MoneyGram International, Inc.	NasdaqGS:MGI	Data Processing and Outsourced Services
Chemung Financial Corporation	NasdaqGS:CHMG	Regional Banks
Codorus Valley Bancorp, Inc.	NasdaqGM:CVLY	Regional Banks
First Business Financial Services, Inc.	NasdaqGS:FBIZ	Regional Banks
First Internet Bancorp	NasdaqGS:INBK	Regional Banks
First Bank	NasdaqGM:FRBA	Regional Banks
Penns Woods Bancorp, Inc.	NasdaqGS:PWOD	Regional Banks
Bankwell Financial Group, Inc.	NasdaqGM:BWFG	Regional Banks
OptimizeRx Corporation	NasdaqCM:OPRX	Health Care Technology
Shore Bancshares, Inc.	NasdaqGS:SHBI	Regional Banks
Sify Technologies Limited	NasdaqCM:SIFY	Alternative Carriers
Norwood Financial Corp.	NasdaqGM:NWFL	Regional Banks
LF Capital Acquisition Corp.	NasdaqCM:LFAC	Asset Management and Custody Banks
BCB Bancorp, Inc.	NasdaqGM:BCBP	Regional Banks
Mid Penn Bancorp, Inc.	NasdaqGM:MPB	Regional Banks
The Habit Restaurants, Inc.	NasdaqGM:HABT	Restaurants
MVB Financial Corp.	NasdaqCM:MVBF	Regional Banks
PICO Holdings, Inc.	NasdaqGS:PICO	Environmental and Facilities Services
Calithera Biosciences, Inc.	NasdaqGS:CALA	Biotechnology
Net 1 UEPS Technologies, Inc.	NasdaqGS:UEPS	Data Processing and Outsourced Services
Capital Product Partners L.P.	NasdaqGS:CPLP	Oil and Gas Storage and Transportation
Allegro Merger Corp.	NasdaqCM:ALGR	Asset Management and Custody Banks
Five Prime Therapeutics, Inc.	NasdaqGS:FPRX	Biotechnology
Exela Technologies, Inc.	NasdaqCM:XELA	Data Processing and Outsourced Services
Griffin Industrial Realty, Inc.	NasdaqGM:GRIF	Real Estate Operating Companies
Fulcrum Therapeutics, Inc.	NasdaqGM:FULC	Pharmaceuticals
Galectin Therapeutics, Inc.	NasdaqCM:GALT	Biotechnology
Mammoth Energy Services, Inc.	NasdaqGS:TUSK	Oil and Gas Equipment and Services
Pingtan Marine Enterprise Ltd.	NasdaqCM:PME	Packaged Foods and Meats
Seres Therapeutics, Inc.	NasdaqGS:MCRB	Biotechnology
Athersys, Inc.	NasdaqCM:ATHX	Biotechnology
Exicure, Inc.	NasdaqCM:XCUR	Biotechnology
XPEL, Inc.	NasdaqCM:XPEL	Auto Parts and Equipment
First Capital, Inc.	NasdaqCM:FCAP	Regional Banks
BankFinancial Corporation	NasdaqGS:BFIN	Regional Banks
Bank of Commerce Holdings	NasdaqGM:BOCH	Regional Banks
Mesa Air Group, Inc.	NasdaqGS:MESA	Airlines
DNB Financial Corporation	NasdaqCM:DNBF	Regional Banks
Affimed N.V.	NasdaqGM:AFMD	Biotechnology
GSI Technology, Inc.	NasdaqGS:GSIT	Semiconductors
C&F Financial Corporation	NasdaqGS:CFFI	Regional Banks
Neuronetics, Inc.	NasdaqGM:STIM	Health Care Equipment
First Guaranty Bancshares, Inc.	NasdaqGM:FGBI	Regional Banks
The Bank of Princeton	NasdaqGS:BPRN	Regional Banks
ARYA Sciences Acquisition Corp.	NasdaqCM:ARYA	Asset Management and Custody Banks
Richmond Mutual Bancorporation, Inc.	NasdaqCM:RMBI	Regional Banks
Coastal Financial Corporation	NasdaqGS:CCB	Regional Banks
Citi Trends, Inc.	NasdaqGS:CTRN	Apparel Retail
Pacific Mercantile Bancorp	NasdaqGS:PMBC	Regional Banks
Geospace Technologies Corporation	NasdaqGS:GEOS	Oil and Gas Equipment and Services
China Customer Relations Centers, Inc.	NasdaqCM:CCRC	Office Services and Supplies
Level One Bancorp, Inc.	NasdaqGS:LEVL	Regional Banks
Cytosorbents Corporation	NasdaqCM:CTSO	Health Care Equipment
Emmaus Life Sciences, Inc.	NasdaqCM:EMMA	Pharmaceuticals
The Community Financial Corporation	NasdaqCM:TCFC	Regional Banks
HOOKIPA Pharma Inc.	NasdaqGS:HOOK	Biotechnology
AcelRx Pharmaceuticals, Inc.	NasdaqGM:ACRX	Pharmaceuticals
Cue Biopharma, Inc.	NasdaqCM:CUE	Biotechnology
Yatra Online, Inc.	NasdaqCM:YTRA	Internet and Direct Marketing Retail
Harrow Health, Inc.	NasdaqCM:HROW	Pharmaceuticals
Riverview Bancorp, Inc.	NasdaqGS:RVSB	Thrifts and Mortgage Finance
Martin Midstream Partners L.P.	NasdaqGS:MMLP	Oil and Gas Storage and Transportation
MainStreet Bancshares, Inc.	NasdaqCM:MNSB	Regional Banks
Two River Bancorp	NasdaqGM:TRCB	Regional Banks
United Security Bancshares	NasdaqGS:UBFO	Regional Banks
Evelo Biosciences, Inc.	NasdaqGS:EVLO	Biotechnology
American Superconductor Corporation	NasdaqGS:AMSC	Electrical Components and Equipment
Chimerix, Inc.	NasdaqGM:CMRX	Biotechnology
MMA Capital Holdings, Inc.	NasdaqCM:MMAC	Thrifts and Mortgage Finance
ZAGG Inc	NasdaqGS:ZAGG	Consumer Electronics
MDC Partners Inc.	NasdaqGS:MDCA	Advertising
Synlogic, Inc.	NasdaqGM:SYBX	Biotechnology
Community Bankers Trust Corporation	NasdaqCM:ESXB	Regional Banks
Saga Communications, Inc.	NasdaqGM:SGA	Broadcasting
Gencor Industries, Inc.	NasdaqGM:GENC	Industrial Machinery
Sol-Gel Technologies Ltd.	NasdaqGM:SLGL	Pharmaceuticals
Kura Sushi USA, Inc.	NasdaqGM:KRUS	Restaurants
Kala Pharmaceuticals, Inc.	NasdaqGS:KALA	Pharmaceuticals
FedNat Holding Company	NasdaqGM:FNHC	Property and Casualty Insurance
Bank7 Corp.	NasdaqGS:BSVN	Regional Banks
Lifetime Brands, Inc.	NasdaqGS:LCUT	Housewares and Specialties
Nature's Sunshine Products, Inc.	NasdaqCM:NATR	Personal Products
Foamix Pharmaceuticals Ltd.	NasdaqGM:FOMX	Pharmaceuticals
LiveXLive Media, Inc.	NasdaqCM:LIVX	Movies and Entertainment
LiqTech International, Inc.	NasdaqCM:LIQT	Industrial Machinery
Transcat, Inc.	NasdaqGM:TRNS	Trading Companies and Distributors
Adamas Pharmaceuticals, Inc.	NasdaqGM:ADMS	Biotechnology
Ohio Valley Banc Corp.	NasdaqGM:OVBC	Regional Banks
Axcella Health Inc.	NasdaqGM:AXLA	Biotechnology
Akoustis Technologies, Inc.	NasdaqCM:AKTS	Electronic Components
Clearfield, Inc.	NasdaqGM:CLFD	Communications Equipment
Spero Therapeutics, Inc.	NasdaqGS:SPRO	Biotechnology
Peak Resorts, Inc.	NasdaqGM:SKIS	Leisure Facilities
Sportsman's Warehouse Holdings, Inc.	NasdaqGS:SPWH	Specialty Stores
Peoples Bancorp of North Carolina, Inc.	NasdaqGM:PEBK	Regional Banks
NII Holdings, Inc.	NasdaqGS:NIHD	Wireless Telecommunication Services
Enochian Biosciences Inc.	NasdaqCM:ENOB	Biotechnology
Horizon Technology Finance Corporation	NasdaqGS:HRZN	Asset Management and Custody Banks
Capital Bancorp, Inc.	NasdaqGS:CBNK	Regional Banks
Centric Brands Inc.	NasdaqCM:CTRC	Apparel, Accessories and Luxury Goods
KVH Industries, Inc.	NasdaqGS:KVHI	Communications Equipment
Lexicon Pharmaceuticals, Inc.	NasdaqGS:LXRX	Biotechnology
First Northwest Bancorp	NasdaqGM:FNWB	Regional Banks
ESSA Bancorp, Inc.	NasdaqGS:ESSA	Thrifts and Mortgage Finance
Osmotica Pharmaceuticals plc	NasdaqGS:OSMT	Pharmaceuticals
Sonim Technologies, Inc.	NasdaqGM:SONM	Technology Hardware, Storage and Peripherals
CSI Compressco LP	NasdaqGS:CCLP	Oil and Gas Equipment and Services
Dyadic International, Inc.	NasdaqCM:DYAI	Biotechnology
Escalade, Incorporated	NasdaqGM:ESCA	Leisure Products
RCI Hospitality Holdings, Inc.	NasdaqGM:RICK	Leisure Facilities
Franklin Financial Services Corporation	NasdaqCM:FRAF	Regional Banks
LifeVantage Corporation	NasdaqCM:LFVN	Personal Products
Malvern Bancorp, Inc.	NasdaqGM:MLVF	Regional Banks
Colony Bankcorp, Inc.	NasdaqGM:CBAN	Regional Banks
AstroNova, Inc.	NasdaqGM:ALOT	Technology Hardware, Storage and Peripherals
RigNet, Inc.	NasdaqGS:RNET	Oil and Gas Equipment and Services
Luna Innovations Incorporated	NasdaqCM:LUNA	Electronic Equipment and Instruments
Mackinac Financial Corporation	NasdaqCM:MFNC	Regional Banks
FONAR Corporation	NasdaqCM:FONR	Health Care Equipment
Spark Energy, Inc.	NasdaqGS:SPKE	Electric Utilities
Red Violet, Inc.	NasdaqCM:RDVT	Research and Consulting Services
AXT, Inc.	NasdaqGS:AXTI	Semiconductor Equipment
Paratek Pharmaceuticals, Inc.	NasdaqGM:PRTK	Pharmaceuticals
IntriCon Corporation	NasdaqGM:IIN	Health Care Equipment
Provident Financial Holdings, Inc.	NasdaqGS:PROV	Thrifts and Mortgage Finance
Hallador Energy Company	NasdaqCM:HNRG	Coal and Consumable Fuels
Rockwell Medical, Inc.	NasdaqGM:RMTI	Health Care Supplies
X4 Pharmaceuticals, Inc.	NasdaqCM:XFOR	Biotechnology
Applied Therapeutics, Inc.	NasdaqGM:APLT	Biotechnology
Mersana Therapeutics, Inc.	NasdaqGS:MRSN	Biotechnology
G. Willi-Food International Ltd.	NasdaqCM:WILC	Food Distributors
Prudential Bancorp, Inc.	NasdaqGM:PBIP	Thrifts and Mortgage Finance
Twin Disc, Incorporated	NasdaqGS:TWIN	Construction Machinery and Heavy Trucks
The Eastern Company	NasdaqGM:EML	Industrial Machinery
Pintec Technology Holdings Limited	NasdaqGM:PT	Consumer Finance
Middlefield Banc Corp.	NasdaqCM:MBCN	Regional Banks
Oak Valley Bancorp	NasdaqCM:OVLY	Regional Banks
1st Constitution Bancorp	NasdaqGM:FCCY	Regional Banks
Ramaco Resources, Inc.	NasdaqGS:METC	Steel
First United Corporation	NasdaqGS:FUNC	Regional Banks
FNCB Bancorp, Inc.	NasdaqCM:FNCB	Regional Banks
BioSig Technologies, Inc.	NasdaqCM:BSGM	Health Care Equipment
XOMA Corporation	NasdaqGM:XOMA	Biotechnology
Acacia Research Corporation	NasdaqGS:ACTG	Research and Consulting Services
OP Bancorp	NasdaqGM:OPBK	Thrifts and Mortgage Finance
Avalon GloboCare Corp.	NasdaqCM:AVCO	Health Care Services
First Financial Northwest, Inc.	NasdaqGS:FFNW	Regional Banks
Youngevity International, Inc.	NasdaqCM:YGYI	Personal Products
Soliton, Inc.	NasdaqCM:SOLY	Health Care Equipment
Waitr Holdings Inc.	NasdaqGS:WTRH	Internet and Direct Marketing Retail
Axovant Gene Therapies Ltd.	NasdaqGS:AXGT	Biotechnology
Marrone Bio Innovations, Inc.	NasdaqCM:MBII	Fertilizers and Agricultural Chemicals
Aldeyra Therapeutics, Inc.	NasdaqCM:ALDX	Biotechnology
Ardelyx, Inc.	NasdaqGM:ARDX	Biotechnology
Pensare Acquisition Corp.	NasdaqCM:WRLS	Asset Management and Custody Banks
First Savings Financial Group, Inc.	NasdaqCM:FSFG	Regional Banks
Daseke, Inc.	NasdaqCM:DSKE	Trucking
Synalloy Corporation	NasdaqGM:SYNL	Steel
Auburn National Bancorporation, Inc.	NasdaqGM:AUBN	Regional Banks
Acorda Therapeutics, Inc.	NasdaqGS:ACOR	Biotechnology
Xunlei Limited	NasdaqGS:XNET	Application Software
Marchex, Inc.	NasdaqGS:MCHX	Advertising
Fujian Blue Hat Interactive Entertainment Technology Ltd.	NasdaqCM:BHAT	Interactive Home Entertainment
First Community Corporation	NasdaqCM:FCCO	Regional Banks
Jounce Therapeutics, Inc.	NasdaqGS:JNCE	Biotechnology
EyePoint Pharmaceuticals, Inc.	NasdaqGM:EYPT	Pharmaceuticals
Travelzoo	NasdaqGS:TZOO	Interactive Media and Services
Hawthorn Bancshares, Inc.	NasdaqGS:HWBK	Regional Banks
Health Sciences Acquisitions Corporation	NasdaqCM:HSAC	Asset Management and Custody Banks
Cerecor Inc.	NasdaqCM:CERC	Pharmaceuticals
Bicycle Therapeutics plc	NasdaqGS:BCYC	Biotechnology
Strongbridge Biopharma plc	NasdaqGS:SBBP	Pharmaceuticals
MAM Software Group, Inc.	NasdaqCM:MAMS	Systems Software
RADA Electronic Industries Ltd.	NasdaqCM:RADA	Aerospace and Defense
StealthGas Inc.	NasdaqGS:GASS	Oil and Gas Storage and Transportation
IDEAYA Biosciences, Inc.	NasdaqGS:IDYA	Biotechnology
GlycoMimetics, Inc.	NasdaqGM:GLYC	Biotechnology
Perion Network Ltd.	NasdaqGS:PERI	Advertising
Universal Stainless & Alloy Products, Inc.	NasdaqGS:USAP	Steel
Flexsteel Industries, Inc.	NasdaqGS:FLXS	Home Furnishings
CB Financial Services, Inc.	NasdaqGM:CBFV	Regional Banks
Ultralife Corporation	NasdaqGM:ULBI	Electrical Components and Equipment
Stewardship Financial Corporation	NasdaqCM:SSFN	Regional Banks
NantKwest, Inc.	NasdaqGS:NK	Biotechnology
Bel Fuse Inc.	NasdaqGS:BELF.B	Electronic Components
BioXcel Therapeutics, Inc.	NasdaqCM:BTAI	Biotechnology
Union Bankshares, Inc.	NasdaqGM:UNB	Regional Banks
Wrap Technologies, Inc.	NasdaqCM:WRTC	Electronic Equipment and Instruments
Pixelworks, Inc.	NasdaqGM:PXLW	Semiconductors
Liquidia Technologies, Inc.	NasdaqCM:LQDA	Pharmaceuticals
Bassett Furniture Industries, Incorporated	NasdaqGS:BSET	Home Furnishings
Capitala Finance Corp.	NasdaqGS:CPTA	Asset Management and Custody Banks
Gaia, Inc.	NasdaqGM:GAIA	Movies and Entertainment
Oconee Federal Financial Corp.	NasdaqCM:OFED	Thrifts and Mortgage Finance
Immunic, Inc.	NasdaqCM:IMUX	Biotechnology
Research Frontiers Incorporated	NasdaqCM:REFR	Electronic Equipment and Instruments
Turtle Beach Corporation	NasdaqGM:HEAR	Consumer Electronics
Yangtze River Port and Logistics Limited	NasdaqGS:YRIV	Marine Ports and Services
comScore, Inc.	NasdaqGS:SCOR	Advertising
Standard AVB Financial Corp.	NasdaqCM:STND	Thrifts and Mortgage Finance
LRAD Corporation	NasdaqCM:LRAD	Electronic Equipment and Instruments
Corvus Pharmaceuticals, Inc.	NasdaqGM:CRVS	Biotechnology
Plumas Bancorp	NasdaqCM:PLBC	Regional Banks
Pointer Telocation Ltd.	NasdaqCM:PNTR	Diversified Support Services
PRGX Global, Inc.	NasdaqGS:PRGX	Data Processing and Outsourced Services
Anavex Life Sciences Corp.	NasdaqCM:AVXL	Biotechnology
Proficient Alpha Acquisition Corp.	NasdaqCM:PAAC	Asset Management and Custody Banks
Veru Inc.	NasdaqCM:VERU	Personal Products
Tile Shop Holdings, Inc.	NasdaqGS:TTS	Home Improvement Retail
Olympic Steel, Inc.	NasdaqGS:ZEUS	Steel
Citizens Community Bancorp, Inc.	NasdaqGM:CZWI	Regional Banks
Conformis, Inc.	NasdaqGS:CFMS	Health Care Equipment
Sesen Bio, Inc.	NasdaqGM:SESN	Biotechnology
County Bancorp, Inc.	NasdaqGM:ICBK	Regional Banks
Nymox Pharmaceutical Corporation	NasdaqCM:NYMX	Biotechnology
Mohawk Group Holdings, Inc.	NasdaqCM:MWK	Household Appliances
TESSCO Technologies Incorporated	NasdaqGS:TESS	Communications Equipment
Mustang Bio, Inc.	NasdaqGM:MBIO	Biotechnology
Information Services Group, Inc.	NasdaqGM:III	Data Processing and Outsourced Services
Aptinyx Inc.	NasdaqGS:APTX	Biotechnology
Old Point Financial Corporation	NasdaqCM:OPOF	Regional Banks
Gamida Cell Ltd.	NasdaqGM:GMDA	Biotechnology
Haymaker Acquisition Corp. II	NasdaqCM:HYAC	Asset Management and Custody Banks
ATIF Holdings Limited	NasdaqCM:ATIF	Research and Consulting Services
Silvercrest Asset Management Group Inc.	NasdaqGM:SAMG	Asset Management and Custody Banks
VOXX International Corporation	NasdaqGS:VOXX	Consumer Electronics
Energous Corporation	NasdaqCM:WATT	Electrical Components and Equipment
SharpSpring, Inc.	NasdaqCM:SHSP	Application Software
Rhinebeck Bancorp, Inc.	NasdaqCM:RBKB	Thrifts and Mortgage Finance
Coda Octopus Group, Inc.	NasdaqCM:CODA	Electronic Equipment and Instruments
PolarityTE, Inc.	NasdaqCM:PTE	Biotechnology
Meridian Corporation	NasdaqGS:MRBK	Regional Banks
Airgain, Inc.	NasdaqCM:AIRG	Electronic Components
Intevac, Inc.	NasdaqGS:IVAC	Technology Hardware, Storage and Peripherals
Tocagen Inc.	NasdaqGS:TOCA	Biotechnology
Abeona Therapeutics Inc.	NasdaqCM:ABEO	Biotechnology
First Western Financial, Inc.	NasdaqGS:MYFW	Regional Banks
Limestone Bancorp, Inc.	NasdaqCM:LMST	Regional Banks
TravelCenters of America Inc.	NasdaqGS:TA	Automotive Retail
The ExOne Company	NasdaqGS:XONE	Industrial Machinery
MEI Pharma, Inc.	NasdaqCM:MEIP	Biotechnology
Hexindai Inc.	NasdaqGM:HX	Consumer Finance
Tyme Technologies, Inc.	NasdaqCM:TYME	Biotechnology
China XD Plastics Company Limited	NasdaqGM:CXDC	Auto Parts and Equipment
iCAD, Inc.	NasdaqCM:ICAD	Health Care Technology
Abraxas Petroleum Corporation	NasdaqCM:AXAS	Oil and Gas Exploration and Production
Grindrod Shipping Holdings Ltd.	NasdaqGS:GRIN	Marine
Chicken Soup for the Soul Entertainment, Inc.	NasdaqGM:CSSE	Movies and Entertainment
Manitex International, Inc.	NasdaqCM:MNTX	Construction Machinery and Heavy Trucks
Magal Security Systems Ltd.	NasdaqGM:MAGS	Electronic Equipment and Instruments
RADCOM Ltd.	NasdaqCM:RDCM	Communications Equipment
Endologix, Inc.	NasdaqGS:ELGX	Health Care Supplies
Eton Pharmaceuticals, Inc.	NasdaqGM:ETON	Pharmaceuticals
Steel Connect, Inc.	NasdaqGS:STCN	Data Processing and Outsourced Services
NCS Multistage Holdings, Inc.	NasdaqGS:NCSM	Oil and Gas Equipment and Services
Mmtec, Inc.	NasdaqCM:MTC	Application Software
LSI Industries Inc.	NasdaqGS:LYTS	Electrical Components and Equipment
Akerna Corp.	NasdaqCM:KERN	Research and Consulting Services
scPharmaceuticals Inc.	NasdaqGS:SCPH	Pharmaceuticals
Aduro BioTech, Inc.	NasdaqGS:ADRO	Biotechnology
Shiloh Industries, Inc.	NasdaqGS:SHLO	Auto Parts and Equipment
SB Financial Group, Inc.	NasdaqCM:SBFG	Regional Banks
I.D. Systems, Inc.	NasdaqGM:IDSY	Electronic Equipment and Instruments
Chembio Diagnostics, Inc.	NasdaqCM:CEMI	Health Care Supplies
Eagle Bancorp Montana, Inc.	NasdaqGM:EBMT	Regional Banks
Second Sight Medical Products, Inc.	NasdaqCM:EYES	Health Care Equipment
AVEO Pharmaceuticals, Inc.	NasdaqCM:AVEO	Biotechnology
Salisbury Bancorp, Inc.	NasdaqCM:SAL	Regional Banks
Bank of South Carolina Corporation	NasdaqCM:BKSC	Regional Banks
Gulf Island Fabrication, Inc.	NasdaqGS:GIFI	Oil and Gas Equipment and Services
TransGlobe Energy Corporation	NasdaqGS:TGA	Oil and Gas Exploration and Production
Guaranty Federal Bancshares, Inc.	NasdaqGM:GFED	Thrifts and Mortgage Finance
Torchlight Energy Resources, Inc.	NasdaqCM:TRCH	Oil and Gas Exploration and Production
Frequency Electronics, Inc.	NasdaqGM:FEIM	Electronic Equipment and Instruments
UTStarcom Holdings Corp.	NasdaqGS:UTSI	Communications Equipment
Veritone, Inc.	NasdaqGM:VERI	Application Software
RumbleON, Inc.	NasdaqCM:RMBL	Internet and Direct Marketing Retail
Galmed Pharmaceuticals Ltd.	NasdaqCM:GLMD	Biotechnology
CyberOptics Corporation	NasdaqGM:CYBE	Semiconductor Equipment
Severn Bancorp, Inc.	NasdaqCM:SVBI	Thrifts and Mortgage Finance
Northern Technologies International Corporation	NasdaqGM:NTIC	Specialty Chemicals
Reed's, Inc.	NasdaqCM:REED	Soft Drinks
STRATA Skin Sciences, Inc.	NasdaqCM:SSKN	Health Care Equipment
PCTEL, Inc.	NasdaqGS:PCTI	Communications Equipment
Citizens Holding Company	NasdaqGM:CIZN	Regional Banks
Landmark Bancorp, Inc.	NasdaqGM:LARK	Regional Banks
Cortland Bancorp	NasdaqCM:CLDB	Regional Banks
Novavax, Inc.	NasdaqGS:NVAX	Biotechnology
CM Finance Inc.	NasdaqGS:CMFN	Asset Management and Custody Banks
Assertio Therapeutics, Inc.	NasdaqGS:ASRT	Pharmaceuticals
A-Mark Precious Metals, Inc.	NasdaqGS:AMRK	Specialized Finance
Park City Group, Inc.	NasdaqCM:PCYG	Application Software
Iterum Therapeutics plc	NasdaqGM:ITRM	Pharmaceuticals
Great Elm Capital Group, Inc.	NasdaqGS:GEC	Asset Management and Custody Banks
SMTC Corporation	NasdaqGM:SMTX	Electronic Manufacturing Services
Sensus Healthcare, Inc.	NasdaqCM:SRTS	Health Care Equipment
Riverview Financial Corporation	NasdaqGM:RIVE	Regional Banks
Avenue Therapeutics, Inc.	NasdaqCM:ATXI	Pharmaceuticals
Potbelly Corporation	NasdaqGS:PBPB	Restaurants
Beasley Broadcast Group, Inc.	NasdaqGM:BBGI	Broadcasting
YRC Worldwide Inc.	NasdaqGS:YRCW	Trucking
Aquestive Therapeutics, Inc.	NasdaqGM:AQST	Pharmaceuticals
Alaska Communications Systems Group, Inc.	NasdaqGS:ALSK	Integrated Telecommunication Services
HMN Financial, Inc.	NasdaqGM:HMNF	Thrifts and Mortgage Finance
Aqua Metals, Inc.	NasdaqCM:AQMS	Environmental and Facilities Services
Sotherly Hotels Inc.	NasdaqGM:SOHO	Hotel and Resort REITs
Harvard Bioscience, Inc.	NasdaqGM:HBIO	Life Sciences Tools and Services
Asure Software, Inc.	NasdaqCM:ASUR	Application Software
Allena Pharmaceuticals, Inc.	NasdaqGS:ALNA	Biotechnology
Arbutus Biopharma Corporation	NasdaqGS:ABUS	Biotechnology
Smart Sand, Inc.	NasdaqGS:SND	Oil and Gas Equipment and Services
Everspin Technologies, Inc.	NasdaqGM:MRAM	Semiconductors
Urban One, Inc.	NasdaqCM:UONE.K	Broadcasting
Fennec Pharmaceuticals Inc.	NasdaqCM:FENC	Biotechnology
Verastem, Inc.	NasdaqGM:VSTM	Biotechnology
Kezar Life Sciences, Inc.	NasdaqGS:KZR	Biotechnology
Orion Energy Systems, Inc.	NasdaqCM:OESX	Electrical Components and Equipment
EDAP TMS S.A.	NasdaqGM:EDAP	Health Care Equipment
Electrameccanica Vehicles Corp.	NasdaqCM:SOLO	Automobile Manufacturers
RiceBran Technologies	NasdaqCM:RIBT	Packaged Foods and Meats
Catalyst Biosciences, Inc.	NasdaqCM:CBIO	Biotechnology
Entasis Therapeutics Holdings Inc.	NasdaqGM:ETTX	Biotechnology
Lakeland Industries, Inc.	NasdaqGM:LAKE	Apparel, Accessories and Luxury Goods
Innovative Solutions and Support, Inc.	NasdaqGS:ISSC	Aerospace and Defense
Checkpoint Therapeutics, Inc.	NasdaqCM:CKPT	Biotechnology
Identiv, Inc.	NasdaqCM:INVE	Electronic Equipment and Instruments
Merrimack Pharmaceuticals, Inc.	NasdaqGM:MACK	Biotechnology
Neos Therapeutics, Inc.	NasdaqGM:NEOS	Pharmaceuticals
Emclaire Financial Corp	NasdaqCM:EMCF	Regional Banks
Zovio Inc	NasdaqGS:ZVO	Education Services
Security National Financial Corporation	NasdaqGM:SNFC.A	Thrifts and Mortgage Finance
First National Corporation	NasdaqCM:FXNC	Regional Banks
The ONE Group Hospitality, Inc.	NasdaqCM:STKS	Restaurants
United-Guardian, Inc.	NasdaqGM:UG	Personal Products
Epsilon Energy Ltd.	NasdaqGM:EPSN	Oil and Gas Exploration and Production
TransAct Technologies Incorporated	NasdaqGM:TACT	Technology Hardware, Storage and Peripherals
Cumberland Pharmaceuticals Inc.	NasdaqGS:CPIX	Pharmaceuticals
Sunesis Pharmaceuticals, Inc.	NasdaqCM:SNSS	Biotechnology
Atlanticus Holdings Corporation	NasdaqGS:ATLC	Consumer Finance
Frontier Communications Corporation	NasdaqGS:FTR	Integrated Telecommunication Services
Kopin Corporation	NasdaqGS:KOPN	Semiconductors
Fortress Biotech, Inc.	NasdaqCM:FBIO	Biotechnology
SGOCO Group, Ltd.	NasdaqCM:SGOC	Electronic Equipment and Instruments
Savara Inc.	NasdaqGS:SVRA	Biotechnology
MediWound Ltd.	NasdaqGM:MDWD	Pharmaceuticals
Aquinox Pharmaceuticals, Inc.	NasdaqGM:AQXP	Biotechnology
EMCORE Corporation	NasdaqGM:EMKR	Communications Equipment
Trevi Therapeutics, Inc.	NasdaqGM:TRVI	Pharmaceuticals
Sound Financial Bancorp, Inc.	NasdaqCM:SFBC	Regional Banks
Trevena, Inc.	NasdaqGS:TRVN	Biotechnology
Anixa Biosciences, Inc.	NasdaqCM:ANIX	Biotechnology
Greenlane Holdings, Inc.	NasdaqGM:GNLN	Distributors
Lake Shore Bancorp, Inc.	NasdaqGM:LSBK	Thrifts and Mortgage Finance
CYREN Ltd.	NasdaqCM:CYRN	Systems Software
S&W Seed Company	NasdaqCM:SANW	Agricultural Products
Kingstone Companies, Inc.	NasdaqCM:KINS	Property and Casualty Insurance
Genocea Biosciences, Inc.	NasdaqCM:GNCA	Biotechnology
Community West Bancshares	NasdaqGM:CWBC	Regional Banks
Strattec Security Corporation	NasdaqGM:STRT	Auto Parts and Equipment
Tuscan Holdings Corp.	NasdaqCM:THCB	Asset Management and Custody Banks
Lantronix, Inc.	NasdaqCM:LTRX	Communications Equipment
Selecta Biosciences, Inc.	NasdaqGM:SELB	Biotechnology
NeuBase Therapeutics, Inc.	NasdaqCM:NBSE	Biotechnology
Randolph Bancorp, Inc.	NasdaqGM:RNDB	Thrifts and Mortgage Finance
Cocrystal Pharma, Inc.	NasdaqCM:COCP	Pharmaceuticals
Consumer Portfolio Services, Inc.	NasdaqGM:CPSS	Consumer Finance
Houston Wire & Cable Company	NasdaqGS:HWCC	Trading Companies and Distributors
Natural Health Trends Corp.	NasdaqCM:NHTC	Personal Products
Jerash Holdings (US), Inc.	NasdaqCM:JRSH	Apparel, Accessories and Luxury Goods
Orgenesis Inc.	NasdaqCM:ORGS	Biotechnology
Destination XL Group, Inc.	NasdaqGS:DXLG	Apparel Retail
Natural Alternatives International, Inc.	NasdaqGM:NAII	Personal Products
Neurotrope, Inc.	NasdaqCM:NTRP	Biotechnology
Infinity Pharmaceuticals, Inc.	NasdaqGS:INFI	Biotechnology
Fauquier Bankshares, Inc.	NasdaqCM:FBSS	Regional Banks
AgroFresh Solutions, Inc.	NasdaqGS:AGFS	Fertilizers and Agricultural Chemicals
Brainstorm Cell Therapeutics Inc.	NasdaqCM:BCLI	Biotechnology
Dogness (International) Corporation	NasdaqGM:DOGZ	Apparel, Accessories and Luxury Goods
Otonomy, Inc.	NasdaqGS:OTIC	Pharmaceuticals
Catabasis Pharmaceuticals, Inc.	NasdaqGM:CATB	Biotechnology
Aridis Pharmaceuticals, Inc.	NasdaqCM:ARDS	Biotechnology
Amtech Systems, Inc.	NasdaqGS:ASYS	Semiconductor Equipment
Wellesley Bancorp, Inc.	NasdaqCM:WEBK	Regional Banks
Motus GI Holdings, Inc.	NasdaqCM:MOTS	Health Care Equipment
Aspen Group, Inc.	NasdaqGM:ASPU	Education Services
Menlo Therapeutics Inc.	NasdaqGS:MNLO	Pharmaceuticals
8i Enterprises Acquisition Corp.	NasdaqCM:JFK	Asset Management and Custody Banks
CLPS Incorporation	NasdaqGM:CLPS	IT Consulting and Other Services
Community First Bancshares, Inc.	NasdaqCM:CFBI	Regional Banks
American River Bankshares	NasdaqGS:AMRB	Regional Banks
Richardson Electronics, Ltd.	NasdaqGS:RELL	Technology Distributors
Trident Acquisitions Corp.	NasdaqCM:TDAC	Asset Management and Custody Banks
RF Industries, Ltd.	NasdaqGM:RFIL	Electronic Manufacturing Services
SeaChange International, Inc.	NasdaqGS:SEAC	Application Software
Vaccinex, Inc.	NasdaqCM:VCNX	Biotechnology
Tecogen Inc.	NasdaqCM:TGEN	Building Products
Pluristem Therapeutics Inc.	NasdaqCM:PSTI	Biotechnology
Avadel Pharmaceuticals plc	NasdaqGM:AVDL	Pharmaceuticals
Ovid Therapeutics Inc.	NasdaqGS:OVID	Biotechnology
AmeriServ Financial, Inc.	NasdaqGM:ASRV	Regional Banks
Borqs Technologies, Inc.	NasdaqCM:BRQS	Technology Hardware, Storage and Peripherals
ServiceSource International, Inc.	NasdaqGS:SREV	IT Consulting and Other Services
J.W. Mays, Inc.	NasdaqCM:MAYS	Real Estate Operating Companies
Gridsum Holding Inc.	NasdaqGS:GSUM	Application Software
Hennessy Advisors, Inc.	NasdaqCM:HNNA	Asset Management and Custody Banks
Idera Pharmaceuticals, Inc.	NasdaqCM:IDRA	Biotechnology
ChaSerg Technology Acquisition Corp.	NasdaqCM:CTAC	Asset Management and Custody Banks
USA Truck, Inc.	NasdaqGS:USAK	Trucking
South Mountain Merger Corp.	NasdaqCM:SMMC	Asset Management and Custody Banks
The Alkaline Water Company Inc.	NasdaqCM:WTER	Soft Drinks
Summit State Bank	NasdaqGM:SSBI	Regional Banks
INmune Bio Inc.	NasdaqCM:INMB	Biotechnology
AquaBounty Technologies, Inc.	NasdaqCM:AQB	Biotechnology
Resonant Inc.	NasdaqCM:RESN	Communications Equipment
CohBar, Inc.	NasdaqCM:CWBR	Biotechnology
Rekor Systems, Inc.	NasdaqCM:REKR	Research and Consulting Services
InflaRx N.V.	NasdaqGS:IFRX	Biotechnology
United Bancshares, Inc.	NasdaqGM:UBOH	Regional Banks
NetSol Technologies, Inc.	NasdaqCM:NTWK	Application Software
IF Bancorp, Inc.	NasdaqCM:IROQ	Thrifts and Mortgage Finance
Blink Charging Co.	NasdaqCM:BLNK	Automotive Retail
TKK Symphony Acquisition Corporation	NasdaqCM:TKKS	Asset Management and Custody Banks
Applied Genetic Technologies Corporation	NasdaqGM:AGTC	Biotechnology
ASV Holdings, Inc.	NasdaqCM:ASV	Construction Machinery and Heavy Trucks
The InterGroup Corporation	NasdaqCM:INTG	Real Estate Operating Companies
Aravive, Inc.	NasdaqGS:ARAV	Biotechnology
Novan, Inc.	NasdaqGM:NOVN	Pharmaceuticals
Atomera Incorporated	NasdaqCM:ATOM	Semiconductor Equipment
Virco Mfg. Corporation	NasdaqGM:VIRC	Office Services and Supplies
Lonestar Resources US Inc.	NasdaqGM:LONE	Oil and Gas Exploration and Production
Highpower International, Inc.	NasdaqGM:HPJ	Electrical Components and Equipment
Tuesday Morning Corporation	NasdaqGS:TUES	General Merchandise Stores
Aviat Networks, Inc.	NasdaqGS:AVNW	Communications Equipment
Neon Therapeutics, Inc.	NasdaqGS:NTGN	Biotechnology
Ark Restaurants Corp.	NasdaqGM:ARKR	Restaurants
Optibase Ltd.	NasdaqGM:OBAS	Real Estate Operating Companies
Forum Merger II Corporation	NasdaqCM:FMCI	Asset Management and Custody Banks
Magyar Bancorp, Inc.	NasdaqGM:MGYR	Thrifts and Mortgage Finance
Spring Bank Pharmaceuticals, Inc.	NasdaqCM:SBPH	Biotechnology
Modern Media Acquisition Corp.	NasdaqCM:MMDM	Asset Management and Custody Banks
Champions Oncology, Inc.	NasdaqCM:CSBR	Life Sciences Tools and Services
AMCI Acquisition Corp.	NasdaqCM:AMCI	Asset Management and Custody Banks
Perma-Pipe International Holdings, Inc.	NasdaqGM:PPIH	Industrial Machinery
Phunware, Inc.	NasdaqCM:PHUN	Application Software
MicroVision, Inc.	NasdaqGM:MVIS	Electronic Equipment and Instruments
Equillium, Inc.	NasdaqGM:EQ	Biotechnology
Huttig Building Products, Inc.	NasdaqCM:HBP	Trading Companies and Distributors
Bank of the James Financial Group, Inc.	NasdaqCM:BOTJ	Regional Banks
Alpine Immune Sciences, Inc.	NasdaqGM:ALPN	Biotechnology
Nano Dimension Ltd.	NasdaqCM:NNDM	Technology Hardware, Storage and Peripherals
Emmis Communications Corporation	NasdaqGS:EMMS	Broadcasting
Nicholas Financial, Inc.	NasdaqGS:NICK	Consumer Finance
China Automotive Systems, Inc.	NasdaqCM:CAAS	Auto Parts and Equipment
VBI Vaccines Inc.	NasdaqCM:VBIV	Biotechnology
Ekso Bionics Holdings, Inc.	NasdaqCM:EKSO	Health Care Equipment
Greenpro Capital Corp.	NasdaqCM:GRNQ	Asset Management and Custody Banks
ALJ Regional Holdings, Inc.	NasdaqGM:ALJJ	Data Processing and Outsourced Services
Aware, Inc.	NasdaqGM:AWRE	Application Software
United Bancorp, Inc.	NasdaqCM:UBCP	Regional Banks
FFBW, Inc.	NasdaqCM:FFBW	Thrifts and Mortgage Finance
Soleno Therapeutics, Inc.	NasdaqCM:SLNO	Biotechnology
Adamis Pharmaceuticals Corporation	NasdaqCM:ADMP	Pharmaceuticals
Navios Maritime Containers L.P.	NasdaqGS:NMCI	Marine
Kentucky First Federal Bancorp	NasdaqGM:KFFB	Thrifts and Mortgage Finance
Agile Therapeutics, Inc.	NasdaqCM:AGRX	Pharmaceuticals
RealNetworks, Inc.	NasdaqGS:RNWK	Application Software
Performant Financial Corporation	NasdaqGS:PFMT	Diversified Support Services
Tarena International, Inc.	NasdaqGS:TEDU	Education Services
Marinus Pharmaceuticals, Inc.	NasdaqGM:MRNS	Pharmaceuticals
Leisure Acquisition Corp.	NasdaqCM:LACQ	Asset Management and Custody Banks
China SXT Pharmaceuticals, Inc.	NasdaqCM:SXTC	Personal Products
Surface Oncology, Inc.	NasdaqGM:SURF	Biotechnology
Limbach Holdings, Inc.	NasdaqCM:LMB	Construction and Engineering
Vuzix Corporation	NasdaqCM:VUZI	Consumer Electronics
NantHealth, Inc.	NasdaqGS:NH	Health Care Technology
Newater Technology, Inc.	NasdaqCM:NEWA	Industrial Machinery
ATA Inc.	NasdaqGM:ATAI	Education Services
Pathfinder Bancorp, Inc.	NasdaqCM:PBHC	Regional Banks
Harvest Capital Credit Corporation	NasdaqGM:HCAP	Asset Management and Custody Banks
Key Tronic Corporation	NasdaqGM:KTCC	Electronic Manufacturing Services
Curis, Inc.	NasdaqGM:CRIS	Biotechnology
FreightCar America, Inc.	NasdaqGS:RAIL	Construction Machinery and Heavy Trucks
PFSweb, Inc.	NasdaqCM:PFSW	IT Consulting and Other Services
Sears Hometown and Outlet Stores, Inc.	NasdaqCM:SHOS	Home Improvement Retail
Manhattan Bridge Capital, Inc.	NasdaqCM:LOAN	Mortgage REITs
AGBA Acquisition Limited	NasdaqCM:AGBA	Asset Management and Custody Banks
Outlook Therapeutics, Inc.	NasdaqCM:OTLK	Biotechnology
NewLink Genetics Corporation	NasdaqGM:NLNK	Biotechnology
MTBC, Inc.	NasdaqGM:MTBC	Health Care Technology
Oramed Pharmaceuticals Inc.	NasdaqCM:ORMP	Pharmaceuticals
SORL Auto Parts, Inc.	NasdaqGM:SORL	Auto Parts and Equipment
Finjan Holdings, Inc.	NasdaqCM:FNJN	Systems Software
Infrastructure and Energy Alternatives, Inc.	NasdaqCM:IEA	Construction and Engineering
Intermolecular, Inc.	NasdaqGS:IMI	Semiconductors
Patriot Transportation Holding, Inc.	NasdaqGS:PATI	Trucking
Profire Energy, Inc.	NasdaqCM:PFIE	Oil and Gas Equipment and Services
Vermillion, Inc.	NasdaqCM:VRML	Health Care Equipment
American Resources Corporation	NasdaqCM:AREC	Coal and Consumable Fuels
Super League Gaming, Inc.	NasdaqCM:SLGG	Interactive Media and Services
First US Bancshares, Inc.	NasdaqCM:FUSB	Regional Banks
Tiberius Acquisition Corporation	NasdaqCM:TIBR	Asset Management and Custody Banks
Computer Task Group, Incorporated	NasdaqGS:CTG	IT Consulting and Other Services
Sharps Compliance Corp.	NasdaqCM:SMED	Health Care Services
Pro-Dex, Inc.	NasdaqCM:PDEX	Health Care Equipment
Global Eagle Entertainment Inc.	NasdaqCM:ENT	Movies and Entertainment
Arotech Corporation	NasdaqGM:ARTX	Aerospace and Defense
CSP Inc.	NasdaqGM:CSPI	IT Consulting and Other Services
Opiant Pharmaceuticals, Inc.	NasdaqCM:OPNT	Pharmaceuticals
SCYNEXIS, Inc.	NasdaqGM:SCYX	Pharmaceuticals
Ascena Retail Group, Inc.	NasdaqGS:ASNA	Apparel Retail
Home Federal Bancorp, Inc. of Louisiana	NasdaqCM:HFBL	Thrifts and Mortgage Finance
Constellation Alpha Capital Corp.	NasdaqCM:CNAC	Asset Management and Custody Banks
Wayside Technology Group, Inc.	NasdaqGM:WSTG	Technology Distributors
Patriot National Bancorp, Inc.	NasdaqGM:PNBK	Regional Banks
Unum Therapeutics Inc.	NasdaqGS:UMRX	Biotechnology
First Seacoast Bancorp	NasdaqCM:FSEA	Thrifts and Mortgage Finance
Eyenovia, Inc.	NasdaqCM:EYEN	Pharmaceuticals
Canterbury Park Holding Corporation	NasdaqGM:CPHC	Casinos and Gaming
Educational Development Corporation	NasdaqGM:EDUC	Distributors
Kaixin Auto Holdings	NasdaqCM:KXIN	Automotive Retail
Air T, Inc.	NasdaqGM:AIRT	Air Freight and Logistics
CBM Bancorp, Inc.	NasdaqCM:CBMB	Thrifts and Mortgage Finance
Monocle Acquisition Corporation	NasdaqCM:MNCL	Asset Management and Custody Banks
Rocky Mountain Chocolate Factory, Inc.	NasdaqGM:RMCF	Packaged Foods and Meats
Central Federal Corporation	NasdaqCM:CFBK	Thrifts and Mortgage Finance
Beyond Air, Inc.	NasdaqCM:XAIR	Health Care Equipment
Blueknight Energy Partners, L.P.	NasdaqGM:BKEP	Oil and Gas Storage and Transportation
Broadway Financial Corporation	NasdaqCM:BYFC	Thrifts and Mortgage Finance
Internap Corporation	NasdaqGS:INAP	Internet Services and Infrastructure
Helius Medical Technologies, Inc.	NasdaqCM:HSDT	Health Care Equipment
Elmira Savings Bank	NasdaqCM:ESBK	Thrifts and Mortgage Finance
Salem Media Group, Inc.	NasdaqGM:SALM	Broadcasting
Vertex Energy, Inc.	NasdaqCM:VTNR	Oil and Gas Refining and Marketing
DLH Holdings Corp.	NasdaqCM:DLHC	Human Resource and Employment Services
Otelco Inc.	NasdaqCM:OTEL	Integrated Telecommunication Services
Reven Housing REIT, Inc.	NasdaqCM:RVEN	Residential REITs
Lifeway Foods, Inc.	NasdaqGM:LWAY	Packaged Foods and Meats
Bellicum Pharmaceuticals, Inc.	NasdaqGM:BLCM	Biotechnology
Village Bank and Trust Financial Corp.	NasdaqCM:VBFC	Regional Banks
Clearside Biomedical, Inc.	NasdaqGM:CLSD	Pharmaceuticals
Tandy Leather Factory, Inc.	NasdaqGM:TLF	Apparel Retail
Moleculin Biotech, Inc.	NasdaqCM:MBRX	Biotechnology
Crown Crafts, Inc.	NasdaqCM:CRWS	Textiles
IVERIC bio, Inc.	NasdaqGS:ISEE	Biotechnology
Synacor, Inc.	NasdaqGM:SYNC	Application Software
TAT Technologies Ltd.	NasdaqGM:TATT	Aerospace and Defense
Capstone Turbine Corporation	NasdaqCM:CPST	Heavy Electrical Equipment
Arcimoto, Inc.	NasdaqCM:FUV	Motorcycle Manufacturers
Ever-Glory International Group, Inc.	NasdaqGM:EVK	Apparel, Accessories and Luxury Goods
Full House Resorts, Inc.	NasdaqCM:FLL	Casinos and Gaming
Zosano Pharma Corporation	NasdaqCM:ZSAN	Health Care Equipment
Atlantic American Corporation	NasdaqGM:AAME	Multi-line Insurance
Asta Funding, Inc.	NasdaqGS:ASFI	Consumer Finance
Mitcham Industries, Inc.	NasdaqGS:MIND	Oil and Gas Equipment and Services
iFresh Inc.	NasdaqCM:IFMK	Food Retail
HyreCar Inc.	NasdaqCM:HYRE	Specialized Consumer Services
PLx Pharma Inc.	NasdaqCM:PLXP	Pharmaceuticals
Perceptron, Inc.	NasdaqGM:PRCP	Electronic Equipment and Instruments
Perma-Fix Environmental Services, Inc.	NasdaqCM:PESI	Environmental and Facilities Services
Usio, Inc.	NasdaqCM:USIO	Data Processing and Outsourced Services
Pioneer Power Solutions, Inc.	NasdaqCM:PPSI	Heavy Electrical Equipment
AudioEye, Inc.	NasdaqCM:AEYE	Application Software
Social Reality, Inc.	NasdaqCM:SRAX	Advertising
Odyssey Marine Exploration, Inc.	NasdaqCM:OMEX	Diversified Support Services
Bellerophon Therapeutics, Inc.	NasdaqGM:BLPH	Health Care Equipment
Cinedigm Corp.	NasdaqGM:CIDM	Movies and Entertainment
Hoth Therapeutics, Inc.	NasdaqCM:HOTH	Pharmaceuticals
Maiden Holdings, Ltd.	NasdaqGS:MHLD	Reinsurance
Positive Physicians Holdings, Inc.	NasdaqCM:PPHI	Property and Casualty Insurance
Vascular Biogenics Ltd.	NasdaqGM:VBLT	Biotechnology
GSE Systems, Inc.	NasdaqCM:GVP	Application Software
KBL Merger Corp. IV	NasdaqCM:KBLM	Asset Management and Custody Banks
electroCore, Inc.	NasdaqGS:ECOR	Health Care Equipment
Lincoln Educational Services Corporation	NasdaqGS:LINC	Education Services
MIND C.T.I. Ltd	NasdaqGM:MNDO	Application Software
Kewaunee Scientific Corporation	NasdaqGM:KEQU	Health Care Equipment
Forward Pharma A/S	NasdaqGS:FWP	Biotechnology
Psychemedics Corporation	NasdaqCM:PMD	Health Care Services
Kingold Jewelry, Inc.	NasdaqCM:KGJI	Apparel, Accessories and Luxury Goods
FAT Brands Inc.	NasdaqCM:FAT	Restaurants
vTv Therapeutics Inc.	NasdaqCM:VTVT	Biotechnology
1895 Bancorp of Wisconsin, Inc.	NasdaqCM:BCOW	Thrifts and Mortgage Finance
The9 Limited	NasdaqCM:NCTY	Interactive Home Entertainment
Trinity Biotech plc	NasdaqGS:TRIB	Health Care Equipment
Ecology & Environment, Inc.	NasdaqGM:EEI	Environmental and Facilities Services
China Internet Nationwide Financial Services Inc.	NasdaqGM:CIFS	Investment Banking and Brokerage
RCM Technologies, Inc.	NasdaqGM:RCMT	Research and Consulting Services
ImmuCell Corporation	NasdaqCM:ICCC	Biotechnology
Deswell Industries, Inc.	NasdaqGM:DSWL	Electronic Manufacturing Services
Mid-Southern Bancorp, Inc.	NasdaqCM:MSVB	Thrifts and Mortgage Finance
T2 Biosystems, Inc.	NasdaqGM:TTOO	Biotechnology
Gordon Pointe Acquisition Corp.	NasdaqCM:GPAQ	Asset Management and Custody Banks
Verb Technology Company, Inc.	NasdaqCM:VERB	Application Software
ICC Holdings, Inc.	NasdaqCM:ICCH	Property and Casualty Insurance
Big 5 Sporting Goods Corporation	NasdaqGS:BGFV	Specialty Stores
Tantech Holdings Ltd	NasdaqCM:TANH	Commodity Chemicals
Alberton Acquisition Corporation	NasdaqCM:ALAC	Asset Management and Custody Banks
Lipocine Inc.	NasdaqCM:LPCN	Pharmaceuticals
Polar Power, Inc.	NasdaqCM:POLA	Heavy Electrical Equipment
Charles & Colvard, Ltd.	NasdaqCM:CTHR	Apparel, Accessories and Luxury Goods
Mannatech, Incorporated	NasdaqGS:MTEX	Personal Products
Aptevo Therapeutics Inc.	NasdaqGS:APVO	Biotechnology
Famous Dave's of America, Inc.	NasdaqGS:DAVE	Restaurants
DAVIDsTEA Inc.	NasdaqGM:DTEA	Specialty Stores
China Natural Resources, Inc.	NasdaqCM:CHNR	Diversified Metals and Mining
RAVE Restaurant Group, Inc.	NasdaqCM:RAVE	Restaurants
Gulf Resources, Inc.	NasdaqGS:GURE	Commodity Chemicals
U.S. Auto Parts Network, Inc.	NasdaqGS:PRTS	Internet and Direct Marketing Retail
Opes Acquisition Corp.	NasdaqCM:OPES	Asset Management and Custody Banks
Lazydays Holdings, Inc.	NasdaqCM:LAZY	Automotive Retail
Alimera Sciences, Inc.	NasdaqGM:ALIM	Pharmaceuticals
China HGS Real Estate Inc.	NasdaqCM:HGSH	Real Estate Development
BiondVax Pharmaceuticals Ltd.	NasdaqCM:BVXV	Pharmaceuticals
SenesTech, Inc.	NasdaqCM:SNES	Pharmaceuticals
DiaMedica Therapeutics Inc.	NasdaqCM:DMAC	Biotechnology
Taylor Devices, Inc.	NasdaqCM:TAYD	Industrial Machinery
QuickLogic Corporation	NasdaqCM:QUIK	Semiconductors
Hudson Global, Inc.	NasdaqGS:HSON	Human Resource and Employment Services
Tremont Mortgage Trust	NasdaqCM:TRMT	Mortgage REITs
Seelos Therapeutics, Inc.	NasdaqCM:SEEL	Pharmaceuticals
Town Sports International Holdings, Inc.	NasdaqGM:CLUB	Leisure Facilities
ClearOne, Inc.	NasdaqCM:CLRO	Communications Equipment
SELLAS Life Sciences Group, Inc.	NasdaqCM:SLS	Biotechnology
Leap Therapeutics, Inc.	NasdaqGM:LPTX	Biotechnology
Aclaris Therapeutics, Inc.	NasdaqGS:ACRS	Pharmaceuticals
FuelCell Energy, Inc.	NasdaqGM:FCEL	Electrical Components and Equipment
CTI BioPharma Corp.	NasdaqCM:CTIC	Biotechnology
Eastside Distilling, Inc.	NasdaqCM:EAST	Distillers and Vintners
Stein Mart, Inc.	NasdaqGS:SMRT	Apparel Retail
IRIDEX Corporation	NasdaqGM:IRIX	Health Care Equipment
Estre Ambiental, Inc.	NasdaqGM:ESTR	Environmental and Facilities Services
KemPharm, Inc.	NasdaqGM:KMPH	Pharmaceuticals
Hebron Technology Co., Ltd.	NasdaqCM:HEBT	Industrial Machinery
Schultze Special Purpose Acquisition Corp.	NasdaqCM:SAMA	Asset Management and Custody Banks
VIVUS, Inc.	NasdaqGS:VVUS	Pharmaceuticals
Proteostasis Therapeutics, Inc.	NasdaqGM:PTI	Biotechnology
Sierra Oncology, Inc.	NasdaqGM:SRRA	Biotechnology
Quest Resource Holding Corporation	NasdaqCM:QRHC	Environmental and Facilities Services
Taronis Technologies, Inc.	NasdaqCM:TRNX	Industrial Gases
Communications Systems, Inc.	NasdaqGM:JCS	Communications Equipment
China Jo-Jo Drugstores, Inc.	NasdaqCM:CJJD	Drug Retail
Teligent, Inc.	NasdaqGS:TLGT	Pharmaceuticals
Organovo Holdings, Inc.	NasdaqGM:ONVO	Biotechnology
IMAC Holdings, Inc.	NasdaqCM:IMAC	Health Care Services
O2Micro International Limited	NasdaqGS:OIIM	Semiconductors
Conifer Holdings, Inc.	NasdaqGM:CNFR	Property and Casualty Insurance
Zafgen, Inc.	NasdaqGS:ZFGN	Biotechnology
Riot Blockchain, Inc.	NasdaqCM:RIOT	Application Software
Andina Acquisition Corp. III	NasdaqCM:ANDA	Asset Management and Custody Banks
Akari Therapeutics, Plc	NasdaqCM:AKTX	Pharmaceuticals
Cidara Therapeutics, Inc.	NasdaqGM:CDTX	Biotechnology
PAVmed Inc.	NasdaqCM:PAVM	Health Care Equipment
Bio-Path Holdings, Inc.	NasdaqCM:BPTH	Biotechnology
Celsion Corporation	NasdaqCM:CLSN	Biotechnology
Willamette Valley Vineyards, Inc.	NasdaqCM:WVVI	Distillers and Vintners
ClearSign Combustion Corporation	NasdaqCM:CLIR	Electronic Equipment and Instruments
National Holdings Corporation	NasdaqCM:NHLD	Investment Banking and Brokerage
Melinta Therapeutics, Inc.	NasdaqGS:MLNT	Pharmaceuticals
Biomerica, Inc.	NasdaqCM:BMRA	Health Care Equipment
PDS Biotechnology Corporation	NasdaqCM:PDSB	Biotechnology
Ocean Bio-Chem, Inc.	NasdaqCM:OBCI	Household Products
MDJM Ltd.	NasdaqCM:MDJH	Real Estate Services
Entera Bio Ltd.	NasdaqCM:ENTX	Biotechnology
Data I/O Corporation	NasdaqCM:DAIO	Electronic Manufacturing Services
Fuling Global Inc.	NasdaqCM:FORK	Housewares and Specialties
ContraFect Corporation	NasdaqCM:CFRX	Biotechnology
Qumu Corporation	NasdaqCM:QUMU	Application Software
Miragen Therapeutics, Inc.	NasdaqCM:MGEN	Biotechnology
Nuvectra Corporation	NasdaqGM:NVTR	Health Care Equipment
ENGlobal Corporation	NasdaqCM:ENG	Oil and Gas Equipment and Services
Five Star Senior Living Inc.	NasdaqCM:FVE	Health Care Facilities
Innodata Inc.	NasdaqGM:INOD	Data Processing and Outsourced Services
Celldex Therapeutics, Inc.	NasdaqCM:CLDX	Biotechnology
Interpace Diagnostics Group, Inc.	NasdaqCM:IDXG	Health Care Services
Remark Holdings, Inc.	NasdaqCM:MARK	Internet and Direct Marketing Retail
BioCardia, Inc.	NasdaqCM:BCDA	Biotechnology
BIOLASE, Inc.	NasdaqCM:BIOL	Health Care Equipment
HTG Molecular Diagnostics, Inc.	NasdaqCM:HTGM	Health Care Technology
BioHiTech Global, Inc.	NasdaqCM:BHTG	Environmental and Facilities Services
AutoWeb, Inc.	NasdaqCM:AUTO	Interactive Media and Services
Xcel Brands, Inc.	NasdaqGM:XELB	Advertising
iMedia Brands, Inc.	NasdaqCM:IMBI	Internet and Direct Marketing Retail
Future FinTech Group Inc.	NasdaqCM:FTFT	Packaged Foods and Meats
Unico American Corporation	NasdaqGM:UNAM	Property and Casualty Insurance
Global Self Storage, Inc.	NasdaqCM:SELF	Specialized REITs
HV Bancorp, Inc.	NasdaqCM:HVBC	Thrifts and Mortgage Finance
Jewett-Cameron Trading Company Ltd.	NasdaqCM:JCTC.F	Building Products
FlexShopper, Inc.	NasdaqCM:FPAY	Specialized Finance
Aehr Test Systems	NasdaqCM:AEHR	Semiconductor Equipment
Performance Shipping Inc.	NasdaqGS:DCIX	Marine
WVS Financial Corp.	NasdaqGM:WVFC	Thrifts and Mortgage Finance
Puhui Wealth Investment Management Co., Ltd.	NasdaqCM:PHCF	Asset Management and Custody Banks
Powerbridge Technologies Co., Ltd.	NasdaqCM:PBTS	Systems Software
Support.com, Inc.	NasdaqCM:SPRT	Application Software
1347 Property Insurance Holdings, Inc.	NasdaqGM:PIH	Property and Casualty Insurance
CBAK Energy Technology, Inc.	NasdaqCM:CBAT	Electronic Components
Broadwind Energy, Inc.	NasdaqCM:BWEN	Heavy Electrical Equipment
Glen Burnie Bancorp	NasdaqCM:GLBZ	Regional Banks
Restoration Robotics, Inc.	NasdaqGM:HAIR	Health Care Equipment
Sky Solar Holdings, Ltd.	NasdaqCM:SKYS	Renewable Electricity
U.S. Global Investors, Inc.	NasdaqCM:GROW	Asset Management and Custody Banks
Streamline Health Solutions, Inc.	NasdaqCM:STRM	Health Care Technology
Envision Solar International, Inc.	NasdaqCM:EVSI	Semiconductors
Big Rock Partners Acquisition Corp.	NasdaqCM:BRPA	Health Care Facilities
Altimmune, Inc.	NasdaqGM:ALT	Biotechnology
The National Security Group, Inc.	NasdaqGM:NSEC	Property and Casualty Insurance
Gevo, Inc.	NasdaqCM:GEVO	Oil and Gas Refining and Marketing
Wilhelmina International, Inc.	NasdaqCM:WHLM	Diversified Support Services
Asia Pacific Wire & Cable Corporation Limited	NasdaqGM:APWC	Electrical Components and Equipment
Senmiao Technology Limited	NasdaqCM:AIHS	Consumer Finance
Arcadia Biosciences, Inc.	NasdaqCM:RKDA	Agricultural Products
Pacific Ethanol, Inc.	NasdaqCM:PEIX	Oil and Gas Refining and Marketing
Aerpio Pharmaceuticals, Inc.	NasdaqCM:ARPO	Pharmaceuticals
Boxlight Corporation	NasdaqCM:BOXL	Technology Hardware, Storage and Peripherals
Zion Oil & Gas, Inc.	NasdaqCM:ZN	Oil and Gas Exploration and Production
TMSR Holding Company Limited	NasdaqCM:TMSR	Industrial Machinery
Optical Cable Corporation	NasdaqGM:OCC	Communications Equipment
One Stop Systems, Inc.	NasdaqCM:OSS	Technology Hardware, Storage and Peripherals
Caladrius Biosciences, Inc.	NasdaqCM:CLBS	Biotechnology
Tenzing Acquisition Corp.	NasdaqCM:TZAC	Asset Management and Custody Banks
Command Center, Inc.	NasdaqCM:CCNI	Human Resource and Employment Services
Image Sensing Systems, Inc.	NasdaqCM:ISNS	Electronic Equipment and Instruments
Microbot Medical Inc.	NasdaqCM:MBOT	Health Care Equipment
CPI Card Group Inc.	NasdaqCM:PMTS	Technology Hardware, Storage and Peripherals
Citius Pharmaceuticals, Inc.	NasdaqCM:CTXR	Pharmaceuticals
Gyrodyne, LLC	NasdaqCM:GYRO	Real Estate Operating Companies
Fuel Tech, Inc.	NasdaqGS:FTEK	Environmental and Facilities Services
AzurRx BioPharma, Inc.	NasdaqCM:AZRX	Biotechnology
GigaMedia Limited	NasdaqCM:GIGM	Interactive Home Entertainment
Sienna Biopharmaceuticals, Inc.	NasdaqGS:SNNA	Pharmaceuticals
Lightbridge Corporation	NasdaqCM:LTBR	Research and Consulting Services
Westell Technologies, Inc.	NasdaqCM:WSTL	Communications Equipment
Diversified Restaurant Holdings, Inc.	NasdaqCM:SAUC	Restaurants
Neonode Inc.	NasdaqCM:NEON	Electronic Manufacturing Services
Wealthbridge Acquisition Limited	NasdaqCM:HHHH	Asset Management and Custody Banks
GTx, Inc.	NasdaqCM:ONCT	Biotechnology
Eagle Financial Bancorp, Inc.	NasdaqCM:EFBI	Thrifts and Mortgage Finance
CVD Equipment Corporation	NasdaqCM:CVV	Semiconductor Equipment
Rubicon Technology, Inc.	NasdaqCM:RBCN	Semiconductor Equipment
Acer Therapeutics Inc.	NasdaqCM:ACER	Pharmaceuticals
P&F Industries, Inc.	NasdaqGM:PFIN	Household Appliances
Good Times Restaurants Inc.	NasdaqCM:GTIM	Restaurants
ChinaCache International Holdings Ltd.	NasdaqGS:CCIH	Internet Services and Infrastructure
The Peck Company Holdings, Inc.	NasdaqCM:PECK	Construction and Engineering
Hudson Technologies Inc.	NasdaqCM:HDSN	Environmental and Facilities Services
ProPhase Labs, Inc.	NasdaqCM:PRPH	Pharmaceuticals
DarioHealth Corp.	NasdaqCM:DRIO	Health Care Equipment
Cassava Sciences, Inc.	NasdaqCM:SAVA	Pharmaceuticals
Aytu BioScience, Inc.	NasdaqCM:AYTU	Pharmaceuticals
OncoSec Medical Incorporated	NasdaqCM:ONCS	Biotechnology
Coffee Holding Co., Inc.	NasdaqCM:JVA	Packaged Foods and Meats
Soligenix, Inc.	NasdaqCM:SNGX	Biotechnology
Monaker Group, Inc.	NasdaqCM:MKGI	Internet and Direct Marketing Retail
Integrated Media Technology Limited	NasdaqCM:IMTE	Electronic Equipment and Instruments
Datasea Inc.	NasdaqCM:DTSS	Systems Software
Taoping Inc.	NasdaqCM:TAOP	IT Consulting and Other Services
Co-Diagnostics, Inc.	NasdaqCM:CODX	Health Care Equipment
ReTo Eco-Solutions, Inc.	NasdaqCM:RETO	Construction Materials
EdtechX Holdings Acquisition Corp.	NasdaqCM:EDTX	Asset Management and Custody Banks
VistaGen Therapeutics, Inc.	NasdaqCM:VTGN	Biotechnology
DD3 Acquisition Corp.	NasdaqCM:DDMX	Asset Management and Custody Banks
ReWalk Robotics Ltd.	NasdaqCM:RWLK	Health Care Equipment
Diversicare Healthcare Services, Inc.	NasdaqCM:DVCR	Health Care Facilities
Nova LifeStyle, Inc.	NasdaqCM:NVFY	Home Furnishings
Evoke Pharma, Inc.	NasdaqCM:EVOK	Pharmaceuticals
ChinaNet Online Holdings, Inc.	NasdaqCM:CNET	Advertising
Salarius Pharmaceuticals, Inc.	NasdaqCM:SLRX	Biotechnology
Heat Biologics, Inc.	NasdaqCM:HTBX	Biotechnology
Approach Resources, Inc.	NasdaqGS:AREX	Oil and Gas Exploration and Production
NanoVibronix, Inc.	NasdaqCM:NAOV	Health Care Equipment
Cellectar Biosciences, Inc.	NasdaqCM:CLRB	Biotechnology
Bioanalytical Systems, Inc.	NasdaqCM:BASI	Life Sciences Tools and Services
Summit Wireless Technologies, Inc.	NasdaqCM:WISA	Semiconductors
Huitao Technology Co., Ltd.	NasdaqCM:HHT	Construction Materials
U.S. Gold Corp.	NasdaqCM:USAU	Diversified Metals and Mining
Atossa Genetics Inc.	NasdaqCM:ATOS	Health Care Equipment
Bionano Genomics, Inc.	NasdaqCM:BNGO	Life Sciences Tools and Services
Pyxis Tankers Inc.	NasdaqCM:PXS	Marine
Tottenham Acquisition I Limited	NasdaqCM:TOTA	Asset Management and Custody Banks
ZK International Group Co., Ltd.	NasdaqCM:ZKIN	Steel
SigmaTron International, Inc.	NasdaqCM:SGMA	Electronic Manufacturing Services
Greenland Acquisition Corporation	NasdaqCM:GLAC	Asset Management and Custody Banks
Anchiano Therapeutics Ltd	NasdaqCM:ANCN	Biotechnology
SCWorx Corp.	NasdaqCM:WORX	Health Care Technology
Black Ridge Acquisition Corp.	NasdaqCM:BRAC	Asset Management and Custody Banks
Medalist Diversified REIT, Inc.	NasdaqCM:MDRR	Diversified REITs
HL Acquisition Corp.	NasdaqCM:HCCH	Asset Management and Custody Banks
Kirkland's, Inc.	NasdaqGS:KIRK	Homefurnishing Retail
Creative Realities, Inc.	NasdaqCM:CREX	Advertising
Dynasil Corporation of America	NasdaqCM:DYSL	Electronic Equipment and Instruments
VirTra, Inc.	NasdaqCM:VTSI	Aerospace and Defense
Biocept, Inc.	NasdaqCM:BIOC	Biotechnology
JAKKS Pacific, Inc.	NasdaqGS:JAKK	Leisure Products
CUI Global, Inc.	NasdaqCM:CUI	Electronic Equipment and Instruments
Predictive Oncology Inc.	NasdaqCM:POAI	Health Care Supplies
Aemetis, Inc.	NasdaqGM:AMTX	Oil and Gas Refining and Marketing
LightPath Technologies, Inc.	NasdaqCM:LPTH	Electronic Equipment and Instruments
Sypris Solutions, Inc.	NasdaqGM:SYPR	Auto Parts and Equipment
Valeritas Holdings, Inc.	NasdaqCM:VLRX	Health Care Supplies
Longevity Acquisition Corporation	NasdaqCM:LOAC	Asset Management and Custody Banks
Vical Incorporated	NasdaqCM:VICL	Biotechnology
Hancock Jaffe Laboratories, Inc.	NasdaqCM:HJLI	Health Care Equipment
Taitron Components Incorporated	NasdaqCM:TAIT	Technology Distributors
Histogenics Corporation	NasdaqCM:HSGX	Biotechnology
ADDvantage Technologies Group, Inc.	NasdaqGM:AEY	Technology Distributors
China Lending Corporation	NasdaqCM:CLDC	Consumer Finance
China Finance Online Co. Limited	NasdaqGS:JRJC	Investment Banking and Brokerage
Adial Pharmaceuticals, Inc.	NasdaqCM:ADIL	Pharmaceuticals
Origin Agritech Limited	NasdaqGS:SEED	Agricultural Products
BSQUARE Corporation	NasdaqGM:BSQR	Application Software
Precipio, Inc.	NasdaqCM:PRPO	Health Care Services
TDH Holdings, Inc.	NasdaqCM:PETZ	Packaged Foods and Meats
Comstock Holding Companies, Inc.	NasdaqCM:CHCI	Homebuilding
Fibrocell Science, Inc.	NasdaqCM:FCSC	Biotechnology
Tetraphase Pharmaceuticals, Inc.	NasdaqGS:TTPH	Pharmaceuticals
Ossen Innovation Co., Ltd.	NasdaqCM:OSN	Steel
IZEA Worldwide, Inc.	NasdaqCM:IZEA	Interactive Media and Services
SITO Mobile, Ltd.	NasdaqCM:SITO	Application Software
Obalon Therapeutics, Inc.	NasdaqGM:OBLN	Health Care Equipment
Ritter Pharmaceuticals, Inc.	NasdaqCM:RTTR	Pharmaceuticals
Cool Holdings, Inc.	NasdaqCM:AWSM	Computer and Electronics Retail
Pulmatrix, Inc.	NasdaqCM:PULM	Pharmaceuticals
NF Energy Saving Corporation	NasdaqCM:BIMI	Industrial Machinery
ShiftPixy, Inc.	NasdaqCM:PIXY	Human Resource and Employment Services
Check-Cap Ltd.	NasdaqCM:CHEK	Health Care Equipment
SPAR Group, Inc.	NasdaqCM:SGRP	Advertising
EuroDry Ltd.	NasdaqCM:EDRY	Marine
Farmmi, Inc.	NasdaqCM:FAMI	Packaged Foods and Meats
Lianluo Smart Limited	NasdaqCM:LLIT	Health Care Equipment
VivoPower International PLC	NasdaqCM:VVPR	Renewable Electricity
Cleveland BioLabs, Inc.	NasdaqCM:CBLI	Biotechnology
MYOS RENS Technology Inc.	NasdaqCM:MYOS	Personal Products
Intec Pharma Ltd.	NasdaqCM:NTEC	Biotechnology
SuperCom Ltd.	NasdaqCM:SPCB	Electronic Equipment and Instruments
Net Element, Inc.	NasdaqCM:NETE	Application Software
AMERI Holdings, Inc.	NasdaqCM:AMRH	IT Consulting and Other Services
Shineco, Inc.	NasdaqCM:TYHT	Personal Products
Socket Mobile, Inc.	NasdaqCM:SCKT	Technology Hardware, Storage and Peripherals
Eltek Ltd.	NasdaqCM:ELTK	Electronic Components
Cyanotech Corporation	NasdaqCM:CYAN	Personal Products
Dolphin Entertainment, Inc.	NasdaqCM:DLPN	Movies and Entertainment
Guardion Health Sciences, Inc.	NasdaqCM:GHSI	Personal Products
Jason Industries, Inc.	NasdaqCM:JASN	Industrial Machinery
Koss Corporation	NasdaqCM:KOSS	Consumer Electronics
Onconova Therapeutics, Inc.	NasdaqCM:ONTX	Pharmaceuticals
Digital Ally, Inc.	NasdaqCM:DGLY	Electronic Equipment and Instruments
On Track Innovations Ltd.	NasdaqCM:OTIV	Technology Hardware, Storage and Peripherals
Achieve Life Sciences, Inc.	NasdaqCM:ACHV	Biotechnology
Recon Technology, Ltd.	NasdaqCM:RCON	Oil and Gas Equipment and Services
Aileron Therapeutics, Inc.	NasdaqGM:ALRN	Biotechnology
Marin Software Incorporated	NasdaqGM:MRIN	Application Software
Sunworks, Inc.	NasdaqCM:SUNW	Electrical Components and Equipment
Mid-Con Energy Partners, LP	NasdaqGS:MCEP	Oil and Gas Exploration and Production
Novelion Therapeutics Inc.	NasdaqGS:NVLN	Biotechnology
ADOMANI, Inc.	NasdaqCM:ADOM	Auto Parts and Equipment
Edison Nation, Inc.	NasdaqCM:EDNT	Leisure Products
SAExploration Holdings, Inc.	NasdaqCM:SAEX	Oil and Gas Equipment and Services
TRACON Pharmaceuticals, Inc.	NasdaqGM:TCON	Biotechnology
Staffing 360 Solutions, Inc.	NasdaqCM:STAF	Human Resource and Employment Services
Marathon Patent Group, Inc.	NasdaqCM:MARA	Data Processing and Outsourced Services
Astrotech Corporation	NasdaqCM:ASTC	Aerospace and Defense
BIO-key International, Inc.	NasdaqCM:BKYI	Systems Software
Seanergy Maritime Holdings Corp.	NasdaqCM:SHIP	Marine
JMU Limited	NasdaqGM:JMU	Internet and Direct Marketing Retail
Genprex, Inc.	NasdaqCM:GNPX	Biotechnology
CollPlant Biotechnologies Ltd.	NasdaqCM:CLGN	Biotechnology
IKONICS Corporation	NasdaqCM:IKNX	Specialty Chemicals
AirNet Technology Inc.	NasdaqCM:ANTE	Advertising
Wheeler Real Estate Investment Trust, Inc.	NasdaqCM:WHLR	Retail REITs
CPS Technologies Corporation	NasdaqCM:CPSH	Electronic Components
Dar Bioscience, Inc.	NasdaqCM:DARE	Health Care Supplies
SilverSun Technologies, Inc.	NasdaqCM:SSNT	Systems Software
Aevi Genomic Medicine, Inc.	NasdaqGM:GNMX	Biotechnology
Electro-Sensors, Inc.	NasdaqCM:ELSE	Electronic Equipment and Instruments
Yield10 Bioscience, Inc.	NasdaqCM:YTEN	Biotechnology
Iconix Brand Group, Inc.	NasdaqGS:ICON	Apparel, Accessories and Luxury Goods
Nxt-ID, Inc.	NasdaqCM:NXTD	Systems Software
Bonso Electronics International Inc.	NasdaqCM:BNSO	Electronic Equipment and Instruments
Regulus Therapeutics Inc.	NasdaqCM:RGLS	Biotechnology
Fred's, Inc.	NasdaqGS:FRED	General Merchandise Stores
Insignia Systems, Inc.	NasdaqCM:ISIG	Advertising
Dynatronics Corporation	NasdaqCM:DYNT	Health Care Equipment
Avinger, Inc.	NasdaqCM:AVGR	Health Care Equipment
Live Ventures Incorporated	NasdaqCM:LIVE	Home Furnishings
B.O.S. Better Online Solutions Ltd.	NasdaqCM:BOSC	Communications Equipment
Carver Bancorp, Inc.	NasdaqCM:CARV	Thrifts and Mortgage Finance
Top Ships Inc.	NasdaqCM:TOPS	Oil and Gas Storage and Transportation
Capricor Therapeutics, Inc.	NasdaqCM:CAPR	Biotechnology
aTyr Pharma, Inc.	NasdaqCM:LIFE	Biotechnology
Vaxart, Inc.	NasdaqCM:VXRT	Biotechnology
Reebonz Holding Limited	NasdaqGM:RBZ	Internet and Direct Marketing Retail
Wah Fu Education Group Limited	NasdaqCM:WAFU	Education Services
Sino-Global Shipping America, Ltd.	NasdaqCM:SINO	Marine Ports and Services
Dragon Victory International Limited	NasdaqCM:LYL	Consumer Finance
Applied DNA Sciences, Inc.	NasdaqCM:APDN	Electronic Equipment and Instruments
Titan Pharmaceuticals, Inc.	NasdaqCM:TTNP	Pharmaceuticals
CTI Industries Corporation	NasdaqCM:CTIB	Housewares and Specialties
Forward Industries, Inc.	NasdaqCM:FORD	Apparel, Accessories and Luxury Goods
Diffusion Pharmaceuticals Inc.	NasdaqCM:DFFN	Biotechnology
ENDRA Life Sciences Inc.	NasdaqCM:NDRA	Health Care Equipment
Rexahn Pharmaceuticals, Inc.	NasdaqCM:REXN	Biotechnology
Gemphire Therapeutics Inc.	NasdaqCM:GEMP	Biotechnology
Conatus Pharmaceuticals Inc.	NasdaqGM:CNAT	Biotechnology
The Dixie Group, Inc.	NasdaqGM:DXYN	Home Furnishings
Naked Brand Group Limited	NasdaqCM:NAKD	Apparel, Accessories and Luxury Goods
Destination Maternity Corporation	NasdaqGS:DEST	Apparel Retail
Golden Bull Limited	NasdaqCM:DNJR	Consumer Finance
Francesca's Holdings Corporation	NasdaqGS:FRAN	Apparel Retail
Sigma Labs, Inc.	NasdaqCM:SGLB	Aerospace and Defense
Digirad Corporation	NasdaqGM:DRAD	Health Care Services
Artelo Biosciences, Inc.	NasdaqCM:ARTL	Pharmaceuticals
Qualstar Corporation	NasdaqCM:QBAK	Technology Hardware, Storage and Peripherals
ToughBuilt Industries, Inc.	NasdaqCM:TBLT	Apparel, Accessories and Luxury Goods
Cyclacel Pharmaceuticals, Inc.	NasdaqCM:CYCC	Biotechnology
Art's-Way Manufacturing Co., Inc.	NasdaqCM:ARTW	Agricultural and Farm Machinery
Therapix Biosciences Ltd.	NasdaqCM:TRPX	Biotechnology
Evolving Systems, Inc.	NasdaqCM:EVOL	Application Software
Phio Pharmaceuticals Corp.	NasdaqCM:PHIO	Biotechnology
EyeGate Pharmaceuticals, Inc.	NasdaqCM:EYEG	Pharmaceuticals
Nortech Systems Incorporated	NasdaqCM:NSYS	Electronic Manufacturing Services
ARCA biopharma, Inc.	NasdaqCM:ABIO	Biotechnology
TrovaGene, Inc.	NasdaqCM:TROV	Biotechnology
Internet Gold - Golden Lines Ltd.	NasdaqGS:IGLD	Integrated Telecommunication Services
Schmitt Industries, Inc.	NasdaqCM:SMIT	Electronic Equipment and Instruments
Auris Medical Holding Ltd.	NasdaqCM:EARS	Pharmaceuticals
Trans World Entertainment Corporation	NasdaqCM:TWMC	Specialty Stores
TSR, Inc.	NasdaqCM:TSRI	IT Consulting and Other Services
SemiLEDs Corporation	NasdaqCM:LEDS	Semiconductors
Revolution Lighting Technologies, Inc.	NasdaqCM:RVLT	Electrical Components and Equipment
Xenetic Biosciences, Inc.	NasdaqCM:XBIO	Biotechnology
Cancer Genetics, Inc.	NasdaqCM:CGIX	Biotechnology
Reliv' International, Inc.	NasdaqCM:RELV	Personal Products
Globus Maritime Limited	NasdaqCM:GLBS	Marine
Euro Tech Holdings Company Limited	NasdaqCM:CLWT	Trading Companies and Distributors
Tenax Therapeutics, Inc.	NasdaqCM:TENX	Biotechnology
Ocean Power Technologies, Inc.	NasdaqCM:OPTT	Heavy Electrical Equipment
Highway Holdings Limited	NasdaqCM:HIHO	Industrial Machinery
Apex Global Brands Inc.	NasdaqCM:APEX	Apparel, Accessories and Luxury Goods
MICT, Inc.	NasdaqCM:MICT	Aerospace and Defense
Urban Tea, Inc.	NasdaqCM:MYT	Food Retail
Professional Diversity Network, Inc.	NasdaqCM:IPDN	Interactive Media and Services
Sonoma Pharmaceuticals, Inc.	NasdaqCM:SNOA	Pharmaceuticals
Advaxis, Inc.	NasdaqGS:ADXS	Biotechnology
BroadVision, Inc.	NasdaqCM:BVSN	Application Software
Tonix Pharmaceuticals Holding Corp.	NasdaqGM:TNXP	Biotechnology
Industrial Services of America, Inc.	NasdaqCM:IDSA	Environmental and Facilities Services
Euroseas Ltd.	NasdaqCM:ESEA	Marine
Chanticleer Holdings, Inc.	NasdaqCM:BURG	Restaurants
Liquid Media Group Ltd.	NasdaqCM:YVR	Movies and Entertainment
Energy Focus, Inc.	NasdaqCM:EFOI	Electrical Components and Equipment
CHF Solutions, Inc.	NasdaqCM:CHFS	Health Care Equipment
Genius Brands International, Inc.	NasdaqCM:GNUS	Leisure Products
KBS Fashion Group Limited	NasdaqCM:KBSF	Apparel, Accessories and Luxury Goods
Summer Infant, Inc.	NasdaqCM:SUMR	Leisure Products
American Electric Technologies, Inc	NasdaqCM:SLNG	Electrical Components and Equipment
Cesca Therapeutics Inc.	NasdaqCM:KOOL	Health Care Equipment
DelMar Pharmaceuticals, Inc.	NasdaqCM:DMPI	Biotechnology
MoSys, Inc.	NasdaqCM:MOSY	Semiconductors
Appliance Recycling Centers of America, Inc.	NasdaqCM:ARCI	Specialty Stores
Allied Healthcare Products, Inc.	NasdaqCM:AHPI	Health Care Equipment
U.S. Energy Corp.	NasdaqCM:USEG	Oil and Gas Exploration and Production
Proteon Therapeutics, Inc.	NasdaqGM:PRTO	Biotechnology
Fuwei Films (Holdings) Co., Ltd.	NasdaqCM:FFHL	Commodity Chemicals
InVivo Therapeutics Holdings Corp.	NasdaqCM:NVIV	Health Care Equipment
OptimumBank Holdings, Inc.	NasdaqCM:OPHC	Regional Banks
Oxbridge Re Holdings Limited	NasdaqCM:OXBR	Reinsurance
Inpixon	NasdaqCM:INPX	IT Consulting and Other Services
Ability Inc.	NasdaqCM:ABIL	Aerospace and Defense
Akers Biosciences, Inc.	NasdaqCM:AKER	Health Care Equipment
Aethlon Medical, Inc.	NasdaqCM:AEMD	Health Care Equipment
China Ceramics Co., Ltd.	NasdaqCM:CCCL	Building Products
Westwater Resources, Inc.	NasdaqCM:WWR	Coal and Consumable Fuels
Spherix Incorporated	NasdaqCM:SPEX	Research and Consulting Services
OpGen, Inc.	NasdaqCM:OPGN	Biotechnology
China Recycling Energy Corporation	NasdaqCM:CREG	Environmental and Facilities Services
Technical Communications Corporation	NasdaqCM:TCCO	Communications Equipment
iPic Entertainment Inc.	NasdaqCM:IPIC	Restaurants
China TechFaith Wireless Communication Technology Limited	NasdaqGS:CNTF	Technology Hardware, Storage and Peripherals
Superconductor Technologies Inc.	NasdaqCM:SCON	Electronic Components
Cellect Biotechnology Ltd.	NasdaqCM:APOP	Biotechnology
Stellar Biotechnologies, Inc.	NasdaqCM:EDSA	Biotechnology
Atlas Financial Holdings, Inc.	NasdaqGM:AFH	Property and Casualty Insurance
Cemtrex, Inc.	NasdaqCM:CETX	Electronic Manufacturing Services
Ideal Power Inc.	NasdaqCM:IPWR	Electrical Components and Equipment
SG Blocks, Inc.	NasdaqCM:SGBX	Industrial Machinery
Marine Petroleum Trust	NasdaqCM:MARP.S	Oil and Gas Exploration and Production
Attis Industries, Inc.	NasdaqCM:ATIS	Health Care Services
Vislink Technologies, Inc.	NasdaqCM:VISL	Communications Equipment
Synthesis Energy Systems, Inc.	NasdaqCM:SES	Oil and Gas Equipment and Services
NeuroMetrix, Inc.	NasdaqCM:NURO	Health Care Equipment
Mer Telemanagement Solutions Ltd.	NasdaqCM:MTSL	Application Software
XpresSpa Group, Inc.	NasdaqCM:XSPA	Specialized Consumer Services
DropCar, Inc.	NasdaqCM:DCAR	Specialized Consumer Services
LM Funding America, Inc.	NasdaqCM:LMFA	Specialized Finance
Sphere 3D Corp.	NasdaqCM:ANY	Systems Software
Bat Group, Inc.	NasdaqCM:GLG	Trucking
Plus Therapeutics, Inc.	NasdaqCM:PSTV	Biotechnology
Neuralstem, Inc.	NasdaqCM:CUR	Biotechnology
Bridgeline Digital, Inc.	NasdaqCM:BLIN	Application Software
Hepion Pharmaceuticals, Inc.	NasdaqCM:HEPA	Pharmaceuticals
Sintx Technologies, Inc.	NasdaqCM:SINT	Health Care Equipment
Tokai Pharmaceuticals, Inc.	NasdaqGM:NVUS	Biotechnology
Trillium Therapeutics Inc.	NasdaqCM:TRIL	Biotechnology
Biodel Inc.	NasdaqCM:ALBO	Pharmaceuticals
Mereo BioPharma Group plc	NasdaqGM:MREO	Biotechnology
Hydra Industries Acquisition Corp.	NasdaqCM:INSE	Asset Management and Custody Banks
Aptose Biosciences Inc.	NasdaqCM:APTO	Biotechnology
Sophiris Bio, Inc.	NasdaqCM:SPHS	Biotechnology
Oncolytics Biotech Inc.	NasdaqCM:ONCY	Biotechnology
Paringa Resources Limited	NasdaqCM:PNRL	Coal and Consumable Fuels
ESSA Pharma Inc.	NasdaqCM:EPIX	Biotechnology
Global Partner Acquisition Corp.	NasdaqCM:PRPL	Asset Management and Custody Banks
KLR Energy Acquisition Corp.	NasdaqCM:ROSE	Oil and Gas Exploration and Production
Motif Bio plc	NasdaqCM:MTFB	Pharmaceuticals
Gores Holdings II, Inc.	NasdaqCM:VRRM	Asset Management and Custody Banks
BioLineRx Ltd.	NasdaqCM:BLRX	Biotechnology
Atlantic Acquisition Corp.	NasdaqCM:HFFG	Asset Management and Custody Banks
FinTech Acquisition Corp. II	NasdaqCM:IMXI	Asset Management and Custody Banks
Industrea Acquisition Corp.	NasdaqCM:BBCP	Construction and Engineering
Tiziana Life Sciences PLC	NasdaqGM:TLSA	Biotechnology
XTL Biopharmaceuticals Ltd.	NasdaqCM:XTLB	Biotechnology
Piedmont Lithium Limited	NasdaqCM:PLL	Diversified Metals and Mining
Foresight Autonomous Holdings Ltd.	NasdaqCM:FRSX	Auto Parts and Equipment
M I Acquisitions, Inc.	NasdaqCM:PRTH	Asset Management and Custody Banks
Matlin & Partners Acquisition Corporation	NasdaqCM:USWS	Asset Management and Custody Banks
Osprey Energy Acquisition Corp.	NasdaqCM:FLMN	Asset Management and Custody Banks
Cresud Sociedad Annima Comercial, Inmobiliaria, Financiera y Agropecuaria	NasdaqGS:CRES.Y	Diversified Real Estate Activities
Grupo Financiero Galicia S.A.	NasdaqCM:GGAL	Diversified Banks
Titan Medical Inc.	NasdaqCM:TMDI	Health Care Equipment
Verona Pharma plc	NasdaqGM:VRNA	Pharmaceuticals
BRP Inc.	NasdaqGS:DOOO	Leisure Products
Mogo Inc.	NasdaqGM:MOGO	Consumer Finance
Mountain Province Diamonds Inc.	NasdaqGS:MPVD	Precious Metals and Minerals
IMV Inc.	NasdaqCM:IMV	Biotechnology
Grupo Aeroportuario del Centro Norte, S.A.B. de C.V.	NasdaqGS:OMAB	Airport Services
ChipMOS TECHNOLOGIES (Bermuda) LTD.	NasdaqCM:IMOS	Semiconductors
ASLAN Pharmaceuticals Limited	NasdaqGM:ASLN	Biotechnology
Immutep Limited	NasdaqGM:IMMP	Biotechnology
Kazia Therapeutics Limited	NasdaqCM:KZIA	Biotechnology
OrganiGram Holdings Inc.	NasdaqGS:OGI	Pharmaceuticals
Alithya Group Inc.	NasdaqCM:ALYA	IT Consulting and Other Services
DHX Media Ltd.	NasdaqGM:DHXM	Movies and Entertainment
Zealand Pharma A/S	NasdaqGS:ZEAL	Biotechnology
Itamar Medical Ltd.	NasdaqCM:ITMR	Health Care Equipment
Taiwan Liposome Company, Ltd.	NasdaqGM:TLC	Biotechnology
Alterity Therapeutics Limited	NasdaqCM:ATHE	Biotechnology
Benitec Biopharma Limited	NasdaqCM:BNTC	Biotechnology
Genmab A/S	NasdaqGS:GMAB	Biotechnology
FSB Bancorp, Inc.	NasdaqCM:FSBC	Thrifts and Mortgage Finance
Neovasc Inc.	NasdaqCM:NVCN	Health Care Equipment
Points International Ltd.	NasdaqCM:PCOM	Internet and Direct Marketing Retail
Threshold Pharmaceuticals, Inc.	NasdaqCM:MTEM	Biotechnology
The Stars Group Inc.	NasdaqGS:TSG	Casinos and Gaming
GWG Holdings, Inc.	NasdaqCM:GWGH	Specialized Finance
News Corporation	NasdaqGS:NWS	Publishing
Safe-T Group Ltd	NasdaqCM:SFET	Systems Software
Genetic Technologies Limited	NasdaqCM:GENE	Life Sciences Tools and Services
Immuron Limited	NasdaqCM:IMRN	Biotechnology
Neptune Wellness Solutions Inc.	NasdaqCM:NEPT	Personal Products
Cronos Group Inc.	NasdaqGM:CRON	Pharmaceuticals
Jaguar Animal Health, Inc.	NasdaqCM:JAGX	Pharmaceuticals
Liberty TripAdvisor Holdings, Inc.	NasdaqGS:LTRP.B	Interactive Media and Services
Navient Corporation	NasdaqGS:SLM	Consumer Finance
Monster Digital, Inc.	NasdaqCM:INNT	Technology Hardware, Storage and Peripherals
My Size, Inc.	NasdaqCM:MYSZ	Application Software
Horizon Therapeutics Public Limited Company	NasdaqGS:HZNP	Pharmaceuticals
Brookfield Property Partners L.P.	NasdaqGS:BPYP.P	Real Estate Operating Companies
Liberty Broadband Corporation	NasdaqGS:LBRD.A	Cable and Satellite
Quarterhill Inc.	NasdaqGS:QTRH	Communications Equipment
SPI Energy Co., Ltd.	NasdaqGS:SPI	Semiconductors
Bancorp 34, Inc.	NasdaqCM:BCTF	Thrifts and Mortgage Finance
CounterPath Corporation	NasdaqCM:CPAH	Application Software
Westport Fuel Systems Inc.	NasdaqGS:WPRT	Construction Machinery and Heavy Trucks
Village Farms International, Inc.	NasdaqCM:VFF	Agricultural Products
Cardtronics plc	NasdaqGS:CATM	Data Processing and Outsourced Services
ICON Public Limited Company	NasdaqGS:ICLR	Life Sciences Tools and Services
Kamada Ltd.	NasdaqGS:KMDA	Biotechnology
Arcturus Therapeutics Holdings Inc.	NasdaqGM:ARCT	Biotechnology
PB Bancorp, Inc.	NasdaqCM:PBBI	Thrifts and Mortgage Finance
Kitov Pharma Ltd	NasdaqCM:KTOV	Pharmaceuticals
Mesoblast Limited	NasdaqGS:MESO	Biotechnology
Ottawa Bancorp, Inc.	NasdaqCM:OTTW	Thrifts and Mortgage Finance
Liberty Global Plc	NasdaqGS:LBTY.K	Cable and Satellite
Liberty Global Plc	NasdaqGS:LBTY.B	Cable and Satellite
Nabriva Therapeutics plc	NasdaqGS:NBRV	Pharmaceuticals
Zillow Group, Inc.	NasdaqGS:Z	Interactive Media and Services
Eagle Bulk Shipping Inc.	NasdaqGS:EGLE	Marine
Sequential Brands Group, Inc.	NasdaqCM:SQBG	Apparel, Accessories and Luxury Goods
Viacom Inc.	NasdaqGS:VIA	Movies and Entertainment
Midland States Bancorp, Inc.	NasdaqGS:MSBI	Regional Banks
Medigus Ltd.	NasdaqCM:MDGS	Health Care Equipment
Carolina Trust BancShares, Inc.	NasdaqCM:CART	Regional Banks
Discovery, Inc.	NasdaqGS:DISC.B	Broadcasting
Discovery, Inc.	NasdaqGS:DISC.K	Broadcasting
Hutchison China MediTech Limited	NasdaqGS:HCM	Pharmaceuticals
The Liberty SiriusXM Group	NasdaqGS:LSXM.A	Cable and Satellite
The Liberty SiriusXM Group	NasdaqGS:LSXM.B	Cable and Satellite
China Biologic Products Holdings, Inc.	NasdaqGS:CBPO	Biotechnology
Formula One Group	NasdaqGS:FWON.A	Movies and Entertainment
The Liberty Braves Group	NasdaqGS:BATR.A	Movies and Entertainment
Alta Mesa Resources, Inc.	NasdaqCM:AMR	Oil and Gas Exploration and Production
TORM plc	NasdaqGS:TRMD	Oil and Gas Storage and Transportation
Viveve Medical, Inc.	NasdaqCM:VIVE	Health Care Equipment
Apollo Medical Holdings, Inc.	NasdaqCM:AMEH	Health Care Services
Fox Corporation	NasdaqGS:FOX	Broadcasting
Amerant Bancorp Inc.	NasdaqGS:AMTB.B	Regional Banks
Global Indemnity Limited	NasdaqGS:GBLI	Property and Casualty Insurance
FirstService Corporation	NasdaqGS:FSV	Real Estate Services
Zai Lab Limited	NasdaqGM:ZLAB	Biotechnology
Castor Maritime Inc.	NasdaqCM:CTRM	Marine
Liberty Latin America Ltd.	NasdaqGM:LILA.K	Cable and Satellite
Bel Fuse Inc.	NasdaqGS:BELF.A	Electronic Components
Reading International, Inc.	NasdaqCM:RDIB	Movies and Entertainment
Donegal Group Inc.	NasdaqGS:DGIC.A	Property and Casualty Insurance
Kelly Services, Inc.	NasdaqGS:KELY.B	Human Resource and Employment Services
Seneca Foods Corporation	NasdaqGS:SENE.B	Packaged Foods and Meats
SunOpta Inc.	NasdaqGS:STKL	Packaged Foods and Meats
Central Garden & Pet Company	NasdaqGS:CENT.A	Household Products
Methanex Corporation	NasdaqGS:MEOH	Commodity Chemicals
Rush Enterprises, Inc.	NasdaqGS:RUSH.A	Trading Companies and Distributors
Correvio Pharma Corp.	NasdaqCM:CORV	Pharmaceuticals
Formula Systems (1985) Ltd.	NasdaqGS:FORT.Y	IT Consulting and Other Services
Logitech International S.A.	NasdaqGS:LOGI	Technology Hardware, Storage and Peripherals
Colliers International Group Inc.	NasdaqGS:CIGI	Real Estate Services
QAD Inc.	NasdaqGS:QADB	Application Software
Pan American Silver Corp.	NasdaqGS:PAAS	Silver
Brainsway Ltd.	NasdaqGM:BWAY	Health Care Equipment
RedHill Biopharma Ltd.	NasdaqGM:RDHL	Pharmaceuticals
OvaScience, Inc.	NasdaqGM:MLND	Biotechnology
Sohu.com Limited	NasdaqGS:SOHU	Interactive Media and Services
Aeterna Zentaris Inc.	NasdaqCM:AEZS	Biotechnology
Esquire Communications Ltd.	OTCPK:ESQ	Research and Consulting Services
Sierra Wireless, Inc.	NasdaqGS:SWIR	Communications Equipment
Urban One, Inc.	NasdaqCM:UONE	Broadcasting
Liberty Global Plc	NasdaqGM:LILA	Cable and Satellite
Lpath, Inc.	NasdaqGM:APEN	Biotechnology
SSR Mining Inc.	NasdaqGS:SSRM	Gold
EXFO Inc.	NasdaqGS:EXFO	Communications Equipment
Elbit Systems Ltd.	NasdaqGS:ESLT	Aerospace and Defense
Ballard Power Systems Inc.	NasdaqGM:BLDP	Electrical Components and Equipment
Sundance Energy Australia Limited	NasdaqGM:SNDE	Oil and Gas Exploration and Production
The Descartes Systems Group Inc	NasdaqGS:DSGX	Application Software
TiVo Solutions Inc.	NasdaqGM:TIVO	Application Software
Protective Insurance Corporation	NasdaqGM:PTVC.A	Property and Casualty Insurance
Northeast Bank	NasdaqGM:NBN	Regional Banks
Alkermes plc	NasdaqGS:ALKS	Biotechnology
Dawson Geophysical Company	NasdaqGM:DWSN	Oil and Gas Equipment and Services
Alphabet Inc.	NasdaqGS:GOOG	Interactive Media and Services
Equinix, Inc. (REIT)	NasdaqGS:EQIX	Specialized REITs
Aurinia Pharmaceuticals Inc.	NasdaqGM:AUPH	Biotechnology
Qurate Retail, Inc.	NasdaqGS:QRTE.B	Internet and Direct Marketing Retail
Cellectis S.A.	NasdaqGM:CLLS	Biotechnology
IRSA Propiedades Comerciales S.A.	NasdaqGS:IRCP	Real Estate Operating Companies
Grifols, S.A.	NasdaqGS:GRFS	Biotechnology
Summit Therapeutics plc	NasdaqGM:SMMT	Biotechnology
Ryanair Holdings plc	NasdaqGS:RYAA.Y	Airlines
Evogene Ltd.	NasdaqGM:EVGN	Biotechnology
Midatech Pharma Plc	NasdaqCM:MTP	Biotechnology
B Communications Ltd	NasdaqGS:BCOM	Integrated Telecommunication Services
Vodafone Group Plc	NasdaqGS:VOD	Wireless Telecommunication Services
Galapagos NV	NasdaqGS:GLPG	Biotechnology
DBV Technologies S.A.	NasdaqGS:DBVT	Biotechnology
Celyad SA	NasdaqGM:CYAD	Biotechnology
Biofrontera AG	NasdaqCM:BFRA	Biotechnology
Sanofi	NasdaqGS:SNY	Pharmaceuticals
Genfit SA	NasdaqGS:GNFT	Biotechnology
argenx SE	NasdaqGS:ARGX	Biotechnology
Oasmia Pharmaceutical AB (publ)	NasdaqCM:OASM	Biotechnology
Neothetics, Inc.	NasdaqCM:EVFM	Biotechnology
ASML Holding N.V.	NasdaqGS:ASML	Semiconductor Equipment
ERYTECH Pharma S.A.	NasdaqGS:ERYP	Biotechnology
Telefonaktiebolaget LM Ericsson (publ)	NasdaqGS:ERIC	Communications Equipment
Acasti Pharma Inc.	NasdaqCM:ACST	Pharmaceuticals
FRONTEO, Inc.	NasdaqGS:FTEO	IT Consulting and Other Services
MSB Financial Corp.	NasdaqGM:MSBF	Thrifts and Mortgage Finance
NICE Ltd.	NasdaqGS:NICE	Application Software
